# Elvish to English
# qya to eng
# 1749 word pairs
# deliminator:  = 
#
# DAMS - The Dictionary Additions Management System
# https://github.com/attogram/DAMS
#
# This work is licensed under the Creative Commons Attribution-Share Alike 3.0 Unported License. 
# To view a copy of this license, visit http://creativecommons.org/licenses/by-sa/3.0/ 
# or send a letter to Creative Commons, 171 Second Street, Suite 300, San Francisco, California, 94105, USA.
#
a = oh
aara = dawn
aare = sunlight
aarien = sun maiden
aaye = hail
aha = rage
ai = alas
aikale = peak
ailo = lake
aina = holy
ainatar = god
ainur = angelic spirit
aira = copper colored
airetaare = stately
aista = dread
aksa = narrow path
akso = bone
ala = after
alalme = elm
alalminoore = warwickshire
alasse = joy
alasse = merriment
alda = tree
aldea = tree shadowed
alduuya = trees day
alka = ray of light
alkar = radiance
alkara = brilliant
alkaraa = glory
alkare = brilliance
alkarinqua = glorious
alkarinqua = radiant
alma = wealth
almaarea = blessed
almare = bliss
alqua = swan
alta = big
altariel = galadriel
alya = prosperous
amalda = treetop
aman = valinor
amandi = vowel
ambal = flagstone
ambal = stonepiece
amban = hillside
ambapenda = uphill
ambaron = sunrise
ambaron = uprising
ambart = fate
ambarta = doom
ambaru = inhabited
ammasi = nature
amorta = heave
ampa = hook
ampende = upslope
amu = up
amut = raise
amuu = upwards
an = towards
ana = to
ananta = yet
anarya = sunday
anda = long
andamunda = elephant
ando = gate
andoo = for a long time
andoore = nuumenor
anduune = evening
anduunie = sunset
anga = iron
angaina = ironclad
ango = snake
anka = jaw
ankale = sun
anna = gift
anta = give
ante = giving
antes = gives
anto = mouth
antoe = giver
antu = face
antuulien = returned
anwa = real
anwaa = true
anwae = actual
apsa = food
apsaa = meat
ar = and
ar fanturion = thursday
ar manwen = monday
ar nessaron = friday
ar ulmon = tuesday
ar veruen = wednesday
arauka = rushing
arauka = swift
arda = realm
arie = daytime
arinya = early
arka = narrow
armar = goods
arta = fort
artan = fortress
arya = possessing
assa = hole
assat = opening
assava = holes
asta = month
astaldo = valiant
astavar = months
asto = dust
ata = again
atae = back
atalantea = downfallen
atalta = collapse
ataquae = building
ataque = construction
atar = father
atendea = leap year
atsa = catch
atta = two
aule = invention
aure = daylight
auta = invent
ava = without
avanoote = numberless
avaquet = forbid
avaquet = refuse
benn = would
benta = will
buu = on
crassna = collide
crassne = collides
daana = day
dem = them
dey = they
earen = sea
earenya = sea day
earuile = seaweed
eel = star
ehti = spear
ehtyar = spearman
eket = shortsword
eldaquet = quenya
elemmiire = mercury
elvea = starlike
en = look
ena = looking
end = yonder
enda = core
ende = center
endor = middle earth
endya = middle
ene = looks
enga = except
engwa = sickly
enn = there
enque = six
enquie = week
ento = next
entulesse = return
enwina = old
enyaare = then
enyala = remember
enyalet = commemorate
enyalie = memory
eputera = computer
er = one
era = alone
erda = solitary
erde = germ
erde = seed
erdet = deserted
eresse = solitude
eressea = lonely
erin = remains
erka = prick
erkat = prickle
erkau = spine
eru = but
erume = desert
eruseen = children of eru
eruu = still
eruumea = outer
erya = only
eryaa = single
eryu = once
ess = of
esse = beginning
esta = name
estanesse = firstborn
et = forth
etsir = mouth of river
ett = out
ette = outside
ettele = outerlands
ettelen = foreign
faana = pure white
faare = plenitude
faare = sufficiency
faare = wanted
faarea = enough
faika = mean
faike = contemptible
faina = shining
fainu = release
falanyel = teleri
falasse = beach
falasta = foam
falma = crested wave
falmar = breaking wave
falmarin = sea spirit
falmarin = telerin elf
falqua = mountain pass
falqua = ravine
falquan = longsword
fanga = beard
farea = sufficient
farya = suffice
fasse = shaggy
fasse = tangled hair
fauka = open mouthed
fauka = parched
fauka = thirsty
fea = spirit
fenda = threshold
fenume = dragon
fenumen = dragons
feuya = abhor
feuyae = disgust
feuye = abhors
fifiira = fade away
finde = plait
finde = tress
fine = larch
finie = cunning
finwa = sagacious
fion = hawk
firima = mortal
firimavar = mortals
firinga = necklace
firya = human
firyavar = humans
foa = hoard
foa = treasure
foalooke = serpent
foole = secret
foolima = secretive
formaita = dexterous
formaite = right handed
formen = north
formenya = northern
forya = right hand
fuine = shadow
fuinevar = shadows
furu = lie
fuume = sleep
fuumella = poppy
haaka = yawn
haara = sit
hahta = mound
hahta = pile
haime = habit
haimevar = habits
haiya = far
haiyasse = distance
halatir = kingfisher
halda = hidden
halda = shadowed
halda = veiled
halla = tall
halme = drawing
haloisi = stormy sea
haloite = leaping
halta = leap
halya = veil
halyet = conceal
handa = intelligent
handa = understanding
handasse = intelligence
handele = intellect
hanta = thank
hanu = male
hanya = understand
harna = wounded
harni = king
harwe = treasury
harwe = wound
harya = possess
haryon = heir
haryon = prince
hauta = cease
hautae = nap
heera = chief
heerae = principal
heere = lordship
helda = naked
helin = pansy
helka = icy
helke = ice
helkelimbe = icicle
helma = fell
helta = strip
helyanwe = rainbow
hen = eye
hend = eyes
henulka = evil eyed
heren istarion = order of wizards
herenya = fortunate
herenya = rich
herenya = wealthy
heri = lady
herivar = ladies
heru = lord
heru = rule
heruu = master
heruvar = lords
hesin = winter
heskil = winter child
hessa = withered
hesta = wither
hiise = mist
hiise = misty
hiisime = november
hilde = follower
hilka = freeze
hilkin = freezes
hilya = follow
himba = sticky
himbat = adhering
himya = abide
himyaa = adhere
ho = from
holme = odor
hoopa = haven
hoore = impulse
horma = horde
horma = host
hormavar = hordes
horme = hosts
horme = urgency
horta = send
horta = speed
horta = urge
hos = folk
hossae = band
hosse = army
hosset = troop
hosta = collect
hostae = assemble
hostain = numbered
hostar = tribe
huan = hound
huanuu = hounds
hui = fog
hui = murk
huiva = murky
huo = dog
huota = dogs
hwan = fungus
hwan = sponge
hwarin = crooked
hwarma = crossbar
hwesta = puff
hwesta = puff of air
hwinda = eddy
hwinde = whirlpool
hwinya = gyrate
hwinya = swirl
hyalm = conch
hyalma = horn of ulmu
hyalmet = shell
hyanda = blade
hyandae = ploughshare
hyandavar = blades
hyapat = shore
hyar = plough
hyarmaite = left handed
hyarmen = south
hyarmenya = southern
hyary = cleave
hyarya = left
hyatse = cleft
hyatsh = gash
hyelle = glass
hyoola = trumpet
i = the
iire = when
iiret = desire
iirima = desirable
iiwerin = ireland
ilfirin = immortal
ilma = starlight
ilmen = space
ilterendi = unbreakable
ilterendi = unfileable
ilu = universe
ilya = all
imbe = between
indo = mood
indyo = grandchild
indyou = descendant
inga = first
inge = shot
inge = trajectory
ingole = magic
ingolonde = noldorland
intu = surrender
intya = idea
intyaa = guess
intyae = suppose
intyaet = supposition
intyale = imagination
intyavar = ideas
inya = female
is = snowlight
isilme = moonlight
iska = pale
isqua = wise
isse = knowledge
ista = know
iste = knows
istima = knowledgeable
istima = learned
istimor = noldor
istyar = scholar
istyarvar = scholars
jyet = I
kaane = valor
kaano = commander
kaar = head
kaima = bed
kaimasan = bedroom
kaimasse = sick
kainen = ten
kaita = lie down
kaivokalma = will-o-the-wisp
kaivokalmet = corpse candle
kala = light
kalainis = may
kale = morning
kallasilya = bright
kallo = hero
kallo = nobleman
kalma = lamp
kalmindon = lighthouse
kalpa = water vessel
kalpae = bale
kalpu = scoop
kalya = illuminate
kanta = four
kanu = lead
kanya = bold
kapalinda = pool
kar = house
kara = make
karae = build
karakse = hedge
kard = houses
karka = rock
karkae = tooth
karkaras = spikes
karkaras = teeth
karkat = fang
karku = tusk
karne = red
karneambara = red breasted
karneambara = robin
karnevalina = rejoice in redness
karnil = mars
karu = made
kassa = helmet
kauka = bent
kauko = humpback
kaure = fear
kaurea = timid
kektele = fountain
kelma = channel
kelume = flow
kelume = rising tide
kelume = stream
kelva = animal
kemi = earth
kemii = land
kemina = earthen
kemit = soil
kemnaro = potter
kermie = july
kerta = rune
kilde = teary eyed
kilya = gorge
kilya = pass
kiris = crack
kirisse = slash
kirka = sickle
kirma = part
koimas = waybread
koire = stirring
koiva = wake
kola = carry
kolindo = bearer
kolindoo = carrier
kollo = cloak
koopas = harbor
koranar = solar year
korda = temple
kordon = idol
korima = round
korko = crow
korma = ring
kormare = ring day
korne = loaf
korominda = cupola
koromindo = dome
koron = ball
korono = globe
kortirion = warwick
kosta = quarrel
kotumo = enemy
kotumuu = enemies
kotya = hostile
kua = dove
kuila = alive
kuile = life
kuilea = awake
kuivea = wakening
kulda = flame colored
kulda = golden red
kuluma = orange
kumba = belly
kumbe = heap
kumna = empty
kuru = wizardry
kuruni = white witch
kuruvar = wizard
kurwe = craft
kuuma = vacuum
kuuna = curved
kuune = crescent
kyerme = prayer
laamina = echoing
laar = league
laara = flat
laare = leagues
laika = sharp
laikae = acute
laike = keen
laiqua = green
laiquaninwa = greenish blue
laiquasse = greenness
laiquendi = green elves
laira = shady
laire = meadow
laire = summer
lairelosse = redwood
laisi = new life
laisi = vigor
laita = praise
laive = ointment
laiwa = ill
lakil = victor
lala = no
laly = deny
lambe = language
lambe = native tongue
lamma = sound
lanat = weft
landa = wide
lanko = throat
lanna = tissue
lanne = cloth
lannet = clothes
lanta raana = setting moon
lantane = fall
lante = falling
lanya = weave
lapse = baby
lassa = teenager
lasse = leaf
lassevar = leaves
lasta = hearing
lasta = listen
lata = clear
latin = open
latina = cleared
latuuken = tin
lauka = warm
laurealasse = goldleaf
laurina = golden
lav = allow
lavae = grant
lavu = yield
lemba = left behind
lempe = five
lende = traveled
leneeme = permission
lenka = slow
lenn = stretch
lenwa = long and thin
lepta = finger
leptavar = fingers
lesta = measure
lia = thread
lia = twine
liantasse = vine
liante = spider
liante = tendril
liiko = wax
liikuma = candle
liima = excessive
liime = excessively
lillassea = many leaved
lilta = dance
limba = drop
limbe = many
lin = melody
linde = singing
linde = tune
lindele = music
lindele = song
lindelea = melodious
lindo = singer
lindo = songbird
lindoorea = varied
lindornea = oaks
linga = dangle
linger = hang
lingwe = fish
lingwilooke = sea serpent
linque = water
lintitinwe = starry
lintuilind = swallows
lintyulussea = poplars
lipsa = soap
lipte = drip
liquin = wet
liquis = transparence
lira = sing
lirae = chant
lirilla = lay
lirit = poem
liske = reed
litse = sand
lokse = hair
lokta = sprout
lokte = blossom
loo = night
loome = dusk
loomelinde = nightingale
loomin = shade
loomy = hide
loote = flower
lootelot = flowers
loralya = sleeping
lorda = drowsy
lorna = asleep
losse = fallen snow
luhta = enchant
luinil = neptune
luka = swallow
lumbar = cloud
lumbara = clouds
lumbaru = saturn
lumbule = darkness
lumenyaare = saga
lumenyaare = tale
lumna = oppressive
lumnaa = burdensome
lumnae = ominous
lumnet = heavy
lunga = sag
lungaa = bend
lunte = ship
luntuu = boat
lussa = whisper
lusta = void
lutu = float
luu = occasion
luuke = enchantment
luume = time
luumequenta = chronicle
luumequentale = history
luumequentalea = historical
luumequentavar = chronicles
luune = blue
luure = weather
luurea = overcast
luvu = brood
luvuu = lower
ly = you
lyaa = yours
maama = sheep
maar = good
maara = fit
maara = useful
mahalma = throne
mahina = machine
mahinuu = machines
mahta = handle
mahta = wield
mahtar = warrior
maika = piercing
maile = lust
mailea = lustful
maite = handy
maite = skilled
maivoine = longing
maiwe = seagull
maka = slay
makar = tradesman
makil = sword
maksa = pliant
maksa = soft
makse = dough
malarauko = balrog
malda = gold
malina = yellow
malle = road
malle = street
mallevar = roads
malo = pollen
malo = powder
malwa = fallow
mammen = where
mamment = whither
manar = fortune
manka = trade
mankale = commerce
manu = departed spirit
mapa = grasp
mapa = seize
mar = home
mara = dwell
marae = homes
maranwe = destiny
marilla = pearl
mart = happen
marta = happens
martae = fated
marte = lucky
martee = luck
martya = destine
marya = fawn
masta = bread
mastae = bake
mat = eat
mata = ate
matuu = eating
maur = vision
maure = need
mausta = compulsion
mauya = compel
mavar = shepherd
meena = region
meetima = final
mektar = swordsman
meldae = beloved
meles = love
melesse = loves
melima = lovable
melin = dear
melindo = boyfriend
melisse = girlfriend
melko = morgoth
melwa = lovely
men = place
men = spot
menel = heaven
menelya = sky day
mennai = until
meoi = cat
mere = wish
merendae = feast
merende = festival
merka = wild
merne = want
merya = festive
mesta = journey
metya = end
metye = ends
mi = in
mii = within
milka = greedy
milme = greed
minas = tower
minda = conspicuous
minde = prominent
mindon = turret
mine = a
minga raana = waning moon
minna = into
minque = eleven
miquil = kiss
miquilis = kisses
miril = shining jewel
mirilya = glitter
mirilye = glitters
mirima = free
miru = wine
miruvoore = nectar
miruvor = mead
misquila = kissing
mista = stray about
miste = rain
mitya = interior
miule = mewing
miule = whining
moile = tarn
moina = familiar
moka = hate
mool = slave
mool = thrall
moore = blackness
moota = labor
mordo = obscurity
mori = black
morimaite = black handed
morko = bear
morna = gloomy
morna = somber
morwen = jupiter
motto = blot
muile = secrecy
mundo = cape
mundoo = snout
murme = slumber
na = be
na rokka = zebra
na rokku = zebras
naa = on the other hand
naar = flame
naarie = june
naikelea = painful
nak = bite
nake = bites
nall = vale
nalla = cry
nallat = crying
nalli = cries
nallo = echo
namaarie = farewell
namba = hammer
nan = backwards
nana = mother
nanda = plain
nanda = water meadow
nandaro = harper
nande = harp
nande = valley
nandele = harping
nandin = dryad
nanquenie = reply
naraka = harsh
naraka = rending
naraka = violent
narda = knot
narki = rend
narmo = wolf
narquelie = october
narvinye = january
nasse = spike
nasse = thorn
nasta = gore
nasta = spearhead
nasta = sting
nat = thing
natse = web
natsee = net
nauken = dwarves
nauko = dwarf
naule = howl
nauro = werewolf
nauta = obliged
nautaa = bound
ne = by
neenar = uranus
neenime = february
neenu = waterlily
neenuvar = waterlilies
neese = youth
nekte = honey
nelde = three
nell = dell
nelle = brook
neltil = triangle
nenda = watery
nengwe = nose
nengwea = nasal
neppa = wrap
neppesse = wrapped
nermi = sprite
nerte = nine
nessa = young
nessima = youthful
neuma = snare
neuna = second
neuro = successor
nielliun = sirius
nienaita = blinking
nienaite = tears
nieninque = snowflake
nier = bee
nierme = weeping
nierwes = hive
niire = tear
niite = moist
nilda = friendly
nilda = loving
nildo = friend
nildovar = friends
ninde = slender
ninque = white
ninquisse = whiteness
ninquitaa = whiten
nique = snow
nirwa = cushion
noa = think
nolda = super
noldo = noldorin elf
noldomire = silmaril
nolwe = lore
nolwe = wisdom
noola = knoll
noora = dwelling
noore = race
nooria = country
nooru = nation
noota = count
noote = number
nootime = countable
nootina = counted
norn = wheel
norno = oak
nornoro = run
norolinde = tripping
norsa = giant
noss = person
nossa = kin
nosse = people
nossu = family
nossuu = clan
nosta = birthday
nostale = kind
nostale = species
nostare = begotten
not = reckon
nukumna = humbled
nukuu = humble
nulla = dark
nuller = obscure
nully = dusky
numenda = low
nupappa = violet
nupappuu = violets
nuquerna = inverted
nuquerna = reversed
nur = complaint
nura = deep
nurra = complain
nuttesa = every
nuty = tie
nuuda = wash
nuume = west
nuumea = western
nuumeheruvi = lords of the west
nuun = below
nuune = underneath
nuuru = grumble
nuuta = set
nuuta = sink
nuuta = stoop
nuuur = rolling
nuuur = smooth
nuvarii = planets
nuvarish = planet
nwalka = cruel
nwalme = anguish
nwalya = pain
nwalya = torment
nyalme = clamor
nyano = rat
nyar = tell
nyeena = lament
nyeene = goat
nyeere = grief
nyelle = bell
o = with
oar = mermaid
oar = sailor
oarn = mermaids
ohta = war
oikta = jewelbox
oio = endless
oira = eternal
ollo = cliff
oloore = dream
oloorea = dreamy
oloorin = gandalf
olva = plant
olvuu = plants
olwa = branch
olwen = wand
olwenn = stick
om = together
omenta = meet
omentie = meeting
ondo = stone
onna = creature
onoone = sister
onooro = brother
onot = add
onta = create
ontaa = beget
ontani = parents
ontaro = parent
ooleme = elbow
ooma = voice
oomalingwe = harp music
oore = rising
oorea = heart
oquenie = discussion
orko = orc
orme = haste
orme = violence
orme = wrath
orna = hasty
orne = high tree
oro = rise
oromarde = hall
oromardeen = hallway
oron = mountain
oronta = steep
oronvar = mountains
orosta = ascension
orto = mountaintop
ossa = wall and moat
osse = terror
osta = homestead
osta = town
ostar = township
osteka = describe
osto = city
otornasse = brotherhood
otorno = associate
otselen = ursa major
otso = seven
palis = lawn
palla = expansive
palme = surface
palpa = beat
palu = spread
palurin = wide world
paluu = extend
paluurien = yavanna
palya = open wide
palyaa = expand
panda = include
pande = includes
pandela = including
pano = floorboard
pano = plank
pano = woodpiece
panta = spread out
panta = unfurl
parka = dry
parma = book
parmaa = writings
parmal = bark
parmee = parchment
parmet = skin
pel = revolve
pele = fence
pelekko = axe
pelekta = hew
peler = field
peltas = pivot
penda = downsloping
penda = inclined
pende = declivity
pendee = downslope
pereldar = danian elves
perina = half
piika = dwindle
piinea = small
pilin = arrow
pilindi = arrows
pilininge = arrow shot
pinque = thin
pinquesta = gun
pio = plum
pioe = cherry
piosenna = holly
pirukendea = whirling
pirya = juice
pirya = syrup
pisser = wicked
piukka = blackberry
poika = clean
poikae = pure
polda = muscular
poldaa = burly
poldore = strength
pole = oat
pore = flour
pore = meal
puita = spit
pusta = stop
pustae = blow
puurea = discolored
quaame = sickness
quaare = hand
quaine = wailing
qualin = dead
qualme = agony
quanta = fill
quanta malle = highway
quantas = full
quelet = corpse
quelie = waning
quendel = elf
quendelian = elvish
quendelie = elves
quent = word
quentale = account
quentaro = narrator
quente = speak
quentele = sentence
querna = turned
quessa = pillows
quesse = feather
quesset = pillow
quet = say
quet = talk
quetil = tongue
quettasundolie = etymology
quinga = bow
quingatelko = bow legged
quingi = twang
quorin = drowned
quorint = choked
quoro = suffocate
quoroe = choke
raaka = break
raakina = broken
raama = wing
raamavoite = winged
raane = straying
raane = wandering
raava = bank
raavae = wilderness
raavea = roaring
raavi = lion
raika = wrong
rakka = claw
rakkalepta = claw fingered
rakta = reach
rakta = stretch out
ramba = wall
rambe = shout
ran = noise
ranga = pace
rangwe = fathom
ranko = arm
ranya = stray
rato = soon
ratse = twelve
rauko = demon
raumo = storm
raumoo = thunder
raust = hunting
raust = preying
rauta = metal
ravenne = lioness
reena = margin
reenae = edge
reenu = border
rempa = hooked
rer = sow
ressutuu = fun
rie = crown
rihta = twitch
rihtavar = jerk
riima = hem
riina = crowned
rilya = glittering
rimba = frequent
rimba = numerous
rimbe = crowd
rimpa = charge
rimpa = flying
rinda = circular
rinde = circle
ringa = cold
ringae = chilly
ringe = mountain pool
ringet = damp
ringwe = frost
ringwe = rime
rinka = shake
rinke = flourish
rista = cut
rithma = program
rithmasse = programming
rithmavar = programs
roina = ruddy
roita = pursue
rokko = horse
rokkuu = horses
ronta = hollow
rooma = bang
rooma = shoulder
roomen = east
roomenya = eastern
roota = tube
rosse = dew
rotele = cave
ruksa = crumble
runda = wood
runya = footprint
runya = trail
ruske = crumbles
russe = sword blade
ruste = crumbling
ruukina = disordered
ruuma = lift
sa = intensive
saa = intense
sakkata = rip
salma = lyre
salme = harp playing
salpa = sup
salpaa = bowl
salpu = sip
salque = grass
sambe = room
samna = post
samno = carpenter
samnoo = wright
sanda = abiding
sanga = gather
sanga = press
sanga = throng
sanka = split
sanke = hateful
sankossi = orcs
sanya = law abiding
sanya = normal
sanya = regular
sanye = law
sanye = reign
sapsa = grave
sar = pebble
sarko = flesh
sarkuva = corporeal
sarkuvae = bodily
sarna = made of stone
sarne = strong place
sarnie = pebble bank
sarnie = shingle
sarqua = fleshy
sarquii = ogre
sarquindi = ogres
saura = evil smelling
saurae = foul
sauray = putrid
saurikumba = foulbellied
seere = peace
seere = repose
selde = daughter
seldo = child
seldovar = children
senda = resting
ser = fond
ser = rest
serke = blood
sii = now
siirima = flowing
siirima = liquid
sikahonda = dagger minded
sikil = dagger
sikila = knife
silda = gleam
silde = gleaming
silme = silver
silme raana = silver moon
silmerosse = silpion
silmo = moon
simpa = flute
simpetar = piper
simpina = pipe
simpise = piping
sina = this
sinda = grey
sindarin = sindarin
sindarinwa = grey elves
sindi = river
sindo = thingol
sinko = jewel
sinome = here
sinqui = jewels
sinquita = bejeweled
sinta = short
sintane = fade
siril = rivulet
sisiila = shine
solme = wave
solor = surge
solosse = surf
soora = trailing
sorne = eagle
sorontar = thorondor
suile = incitement
sukya = drink
sulka = root
sulp = lick
sulpa = soup
sundo = base
sundoe = root word
surya = consonant
suulae = breath
suule = alcohol
suulime = march
suulo = goblet
suume = gust
suuya = breathe
ta = that
taa = high
taal = foot
taapa = block
taape = stops
taapu = blocks
taara = lofty
taari = queen
taarie = height
tailae = lengthening
taile = extension
taina = lengthened
tainae = extended
taita = prolong
take = fasten
takse = nail
tala = sail
talami = ground
talan = floor
talant = fallen
talas = sole
talavar = sails
talma = foundation
talta = leaning
talta = slope
talta = tilted
talwi = feet
tamba = knocking
tambaro = woodpecker
tambe = copper
tamin = forge
tamne = knock
tampa = stopper
tanee = smith
tangwa = hasp
tangwaa = clasp
tanka = sure
tankat = fixed
tankil = brooch
tankila = pin
tannase = lips
tano = craftsman
tanwe = device
tanwee = devices
tar = thither
tara = cross
taran = buffer
tare = beyond
tarkildi = numenoorean
tarna = passage
tarne = crossing
taru = horn
tarukka = horned
tarukko = bull
taruktarna = oxford
taruku = ox
tarya = stiff
tarya = tough
tasarin = willow
tatya = repeat
tatye = double
taule = great tree
taura = mighty
taure = forest
tavari = nymph
tavaro = satyr
tavas = woodland
tea = line
teema = row
teena = straight
tehta = mark
tehta = sign
tehtavar = marks
teke = writes
tekil = pen
telda = roofed
telemna = silvery
telimbo = canopy
telko = leg
telko = stem
telkontar = strider
tella = hindmost
telle = rear
telluma = vault
telme = hood
telmello telmanna = top to bottom
telmet = covering
telta = overshadow
telta = screen
teluumen = sky
telwa = late
telwe = last
ten = for
tena = hear
tengwa = letter
tengwanda = alphabet
tengwe = writing
tengwesta = grammar
tenkele = spelling
tere = through
teret = gimlet
terett = auger
tereva = fine
termara = endure
tevie = hatred
tia = direction
tie = course
tihta = blink
tik = dot
tiks = birthmark
tikse = point
timpine = spray
tinda = glinting
tinde = glint
tindera = hobbit
tinderavar = hobbits
tindoome = starry twilight
tindoomerel = tinuuviel
tinga = flint
tingahondo = flint hearted
tingilinde = twinkling star
tinta = spark
tintaanie = varda
tintila = sparkle
tintila = tremble
tintila = twinkle
tir = heed
tirion = watchtower
tiris = vigil
tiris = walled town
tiris = watch
tirne = brow
titta = tiny
tittu = little
tiuka = thick
tiukaa = fat
tiuko = thigh
toa = woollen
toi = are
tol = island
tolle = islands
tolmen = hill
tolos = knob
tolos = lump
tolto = eight
tombo = gong
too = wool
toopa = roof
tope = covers
tormenta = pic10a
torwa = brotherly
tou = is
touun = was
tu = it
tuileere = spring
tuilere = equinox
tuilindo = pigeon
tuima = bud
tuiya = swell
tuka = draw
tukalia = pull
tulk = set up
tulka = strong
tulkae = establish
tulkan = established
tulkaya = steadfast
tulko = support
tulku = fix
tulkuu = immoveable
tulta = send for
tulta = summon
tulunka = firm
tulunka = steady
tulwe = pillar
tulwe = pole
tulwe = standard
tulya = come
tumbale = deep valley
tumbo = dark vale
tumna = profound
tunga = resonant
tunga = taut
tunga = tight
tunulla = rose
tunulluu = roses
tuo = muscle
tuo = sinew
tuovar = muscles
tupac = see
tupaca = seen
tupse = thatch
tur = govern
turma = shield
turme = conquer
tursa = kindle
turu = firewood
turuuva = wooden
turya = control
tussa = bush
tusture = tinder
tuuma = moving
tuupa = cover
tuure = power
tuurea = victory
tuuree = mastery
tuurindo = tuurin
tuuva = find
tuuvuu = found
tya = do
tyal = play
tyalangan = harp player
tyalie = game
tyalie = sport
tyar = cause
tyara = doer
tyaro = actor
tyaroe = agent
tyav = taste
tyelka = agile
tyelle = grade
tyellvar = grades
tyelma = ending
tyulma = mast
tyulusse = poplar
tyuu = does
ue = fleece
uin = whale
uinen = uinen
ulka = evil
ullume = forever
ulmu = mumble
ulmula = mumbling
ulunde = flood
ulundo = monster
ulundovar = monsters
ulyane = pour
und = beneath
unda = under
undu = down
undume = abyss
ungoliante = ungoliant
ungwa = gloom
ungwale = torture
ungwe = spiderweb
ungweva = cobweb
ungwevar = cobwebs
unquale = death
urna = oven
urwa = flaming
urya = burn
uryuu = blaze
usii = escape
usin = escapes
usque = reek
ussa = we
uu = not
uulea = flooding
uulea = pouring
uumea = vanishing
uuner = nobody
uunootime = countless
uur = fire
uura = large
uure = heat
uurime = august
uuruva = fiery
uuve = abundance
uuvea = abundant
uuveae = huge
uuvee = lots
vaa = went
vaasa = consumer
vae = like
vahaiya = far away
valaina = valar
valasse = divinity
vali = vala
valina = happy
valina = rejoice
valinese = happiness
valka = visible
valya = divine
vanda = oath
vanesse = beauty
vanima = right
vanimaa = fair
vanimo = child of valar
vanimu = proper
vanta = walk
vanwa = over
vanya = beautiful
varda = exalted
varna = safe
varne = brown
varya = protect
ve = as
vene = dish
venet = vessel
venie = shape
verie = boldness
verno = husband
veru = dual
veruu = married couple
verya = dare
vesse = wife
vesta = matrimony
vesta = wed
vestale = wedding
viiresse = april
viirin = moonstone
voi = have
voita = had
voite = having
vorima = everlasting
voro = ever
voron gandele = continous
voronda = faithful
voronwa = enduring
voronwie = endurance
waa = wind
waan = goose
waana = pass away
waani = geese
waara = dirty
waaru = soiled
wahta = stains
wai = ocean
waima = robe
waina = clad
wainae = sheath
wainole = quiver
waksee = stain
wand = path
wande = way
wandl = staff
wanne = disappear
wanwa = gone
wanwaa = lost
wanwae = vanished
wanwie = past
wanya = go
wanyaa = depart
wanye = going
wanyet = goes
waya = envelope
wea = adult
weae = manly
wean = adults
weate = vigorous
wee = us
ween = freshness
weene = virginity
weera = promise
weere = troth
wende = maiden
wendevar = maidens
wenya = fresh
wenya = yellow green
weo = man
weovar = men
wie = manhood
wil = fly
wile = breeze
wilin = bird
wilina = breezy
wilinae = airy
wille = flies
wilma = air
wilwa = fluttering
wilwarin = butterfly
winda = woof
windele = loom
winge = spindrift
winya = new
wuulu = while
ya = who
yaa = ago
yaana = sanctuary
yaana = shrine
yaara = ancient
yaarea = olden
yaaresse = once upon a time
yaavan = harvest
yaave = fruit
yaavie = autumn
yaawe = gully
yahti = neck
yaiwe = mocking
yaiwe = scorn
yallume = at
yan = join
yana = former
yanae = aforementioned
yanna = very
yanta = yoke
yantae = bridge
yanwe = joining
yarra = growl
yarra = snarl
yatta = isthmus
yavannie = september
yaya = which
yee = lo
yeen = bakers dozen
yeeta = view
yello = call
yellp = yalp
yelma = loathing
yelta = loathe
yelwa = loathsome
yenya = year
yerna = worn out
yernit = decrepit
yerya = wear
yo = what
yondo = son
yulda = draught
yulma = brand
yulme = smouldering heat
yulmet = cup
yuna = bump
yuukale = twilight
yuula = smouldering wood
yuulu = ember
yuuyo = both
