# English to ISO639
# eng to ISO639
# 557 translations
# deliminator:  =
#
# DAMS - The Dictionary Additions Management System
# https://github.com/attogram/DAMS
#
# This work is licensed under the Creative Commons Attribution-Share Alike 3.0 Unported License.
# To view a copy of this license, visit http://creativecommons.org/licenses/by-sa/3.0/
# or send a letter to Creative Commons, 171 Second Street, Suite 300, San Francisco, California, 94105, USA.
#
Abkhazian = abk
Achinese = ace
Acoli = ach
Adangme = ada
Adyghe = ady
Afar = aar
Afrihili = afh
Afrikaans = afr
Afro-Asiatic languages = afa
Ainu = ain
Akan = aka
Akkadian = akk
Alacalufan languages = aqa
Albanian = alb
Albanian = sqi
Aleut = ale
Algic languages = aql
Algonquian languages = alg
Altaic languages = tut
Amharic = amh
Ancient Greek = grc
Angika = anp
Apache languages = apa
Arabic = ara
Aragonese = arg
Arapaho = arp
Arauan languages = auf
Arawak = arw
Arawakan languages = awd
Armenian = arm
Armenian = hye
Armenian (family) = hyx
Artificial languages = art
Assamese = asm
Asturian = ast
Athapascan languages = ath
Atlantic-Congo languages = alv
Australian languages = aus
Austro-Asiatic languages = aav
Austronesian languages = map
Avaric = ava
Avestan = ave
Awadhi = awa
Aymara = aym
Azerbaijani = aze
Balinese = ban
Baltic languages = bat
Baluchi = bal
Bambara = bam
Bamileke languages = bai
Banda languages = bad
Bantu languages = bnt
Basa (Cameroon) = bas
Bashkir = bak
Basque = baq
Basque = euq
Basque = eus
Batak languages = btk
Beja = bej
Belarusian = bel
Bemba = bem
Bengali = ben
Berber languages = ber
Bhojpuri = bho
Bihari languages = bih
Bikol = bik
Bilin = byn
Bini = bin
Bislama = bis
Blissymbols = zbl
Bosnian = bos
Braj = bra
Breton = bre
Buginese = bug
Bulgarian = bul
Buriat = bua
Burmese = bur
Burmese = mya
Caddo = cad
Caddoan languages = cdd
Catalan = cat
Caucasian languages = cau
Cebuano = ceb
Celtic languages = cel
Central American Indian languages = cai
Central Khmer = khm
Central Malayo-Polynesian languages = plf
Central Sudanic languages = csu
Chadic languages = cdc
Chagatai = chg
Chamic languages = cmc
Chamorro = cha
Chechen = che
Cherokee = chr
Cheyenne = chy
Chibcha = chb
Chibchan languages = cba
Chinese = chi
Chinese = zho
Chinese (family) = zhx
Chinook jargon = chn
Chipewyan = chp
Choctaw = cho
Church Slavic = chu
Chuukese = chk
Chuvash = chv
Classical Newari = nwc
Classical Syriac = syc
Coptic = cop
Cornish = cor
Corsican = cos
Cree = cre
Creek = mus
Creoles and pidgins = crp
Crimean Tatar = crh
Croatian = hrv
Cushitic languages = cus
Czech = ces
Czech = cze
Dakota = dak
Danish = dan
Dargwa = dar
Delaware = del
Dhivehi = div
Dinka = din
Dogri = doi
Dogrib = dgr
Dravidian languages = dra
Duala = dua
Dutch = dut
Dutch = nld
Dyula = dyu
Dzongkha = dzo
East Germanic languages = gme
East Slavic languages = zle
Eastern Frisian = frs
Eastern Malayo-Polynesian languages = pqe
Eastern Sudanic languages = sdv
Efik = efi
Egyptian (Ancient) = egy
Egyptian languages = egx
Ekajuk = eka
Elamite = elx
English = eng
English based Creoles and pidgins = cpe
Erzya = myv
Eskimo-Aleut languages = esx
Esperanto = epo
Estonian = est
Ewe = ewe
Ewondo = ewo
Fang = fan
Fanti = fat
Faroese = fao
Fijian = fij
Filipino = fil
Finnish = fin
Finno-Ugrian languages = fiu
Fon = fon
Formosan languages = fox
French = fra
French = fre
French-Based Creoles and pidgins = cpf
Friulian = fur
Fulah = ful
Ga = gaa
Galibi Carib = car
Galician = glg
Ganda = lug
Gayo = gay
Gbaya = gba
Ge'ez = gez
Georgian = geo
Georgian = kat
German = deu
German = ger
Germanic languages = gem
Gilbertese = gil
Gondi = gon
Gorontalo = gor
Gothic = got
Grebo = grb
Greek languages = grk
Guarani = grn
Gujarati = guj
Gwichʼin = gwi
Haida = hai
Haitian = hat
Hausa = hau
Hawaiian = haw
Hebrew = heb
Herero = her
Hiligaynon = hil
Himachali languages = him
Hindi = hin
Hiri Motu = hmo
Hittite = hit
Hmong = hmn
Hmong-Mien languages = hmx
Hokan languages = hok
Hungarian = hun
Hupa = hup
Iban = iba
Icelandic = ice
Icelandic = isl
Ido = ido
Igbo = ibo
Ijo languages = ijo
Iloko = ilo
Inari Sami = smn
Indic languages = inc
Indo-European languages = ine
Indo-Iranian languages = iir
Indonesian = ind
Ingush = inh
Interlingua (International Auxiliary Language Association) = ina
Interlingue = ile
Inuktitut = iku
Inupiaq = ipk
Iranian languages = ira
Irish = gle
Iroquoian languages = iro
Italian = ita
Italic languages = itc
Japanese = jpn
Japanese (family) = jpx
Javanese = jav
Judeo-Arabic = jrb
Judeo-Persian = jpr
Kabardian = kbd
Kabyle = kab
Kachin = kac
Kalaallisut = kal
Kalmyk = xal
Kamba = kam
Kannada = kan
Kanuri = kau
Kara-Kalpak = kaa
Karachay-Balkar = krc
Karelian = krl
Karen languages = kar
Kashmiri = kas
Kashubian = csb
Kawi = kaw
Kazakh = kaz
Khasi = kha
Khoisan languages = khi
Khotanese = kho
Kikuyu = kik
Kimbundu = kmb
Kinyarwanda = kin
Kirghiz = kir
Klingon = tlh
Komi = kom
Kongo = kon
Konkani = kok
Kordofanian languages = kdo
Korean = kor
Kosraean = kos
Kpelle = kpe
Kru languages = kro
Kuanyama = kua
Kumyk = kum
Kurdish = kur
Kurukh = kru
Kutenai = kut
Ladino = lad
Lahnda = lah
Lamba = lam
Land Dayak languages = day
Lao = lao
Latin = lat
Latvian = lav
Lezghian = lez
Limburgan = lim
Lingala = lin
Lithuanian = lit
Lojban = jbo
Low German = nds
Lower Sorbian = dsb
Lozi = loz
Luba-Katanga = lub
Luba-Lulua = lua
Luiseno = lui
Lule Sami = smj
Lunda = lun
Luo = luo
Lushai = lus
Luxembourgish = ltz
Macedo-Romanian = rup
Macedonian = mac
Macedonian = mkd
Madurese = mad
Magahi = mag
Maithili = mai
Makasar = mak
Malagasy = mlg
Malay = may
Malay = msa
Malayalam = mal
Malayo-Polynesian languages = poz
Maltese = mlt
Manchu = mnc
Mandar = mdr
Mande languages = dmn
Mandingo = man
Manipuri = mni
Manobo languages = mno
Manx = glv
Maori = mao
Maori = mri
Mapudungun = arn
Marathi = mar
Mari = chm
Marshallese = mah
Marwari = mwr
Masai = mas
Mayan languages = myn
Mende = men
Mi'kmaq = mic
Middle Dutch = dum
Middle English = enm
Middle French = frm
Middle High German = gmh
Middle Irish = mga
Minangkabau = min
Mirandese = mwl
Modern Greek = ell
Modern Greek = gre
Mohawk = moh
Moksha = mdf
Mon-Khmer languages = mkh
Mongo = lol
Mongolian = mon
Mongolian languages = xgn
Mossi = mos
Multiple languages = mul
Munda languages = mun
N'Ko = nqo
Na-Dene languages = xnd
Nahuatl languages = nah
Nauru = nau
Navajo = nav
Ndonga = ndo
Neapolitan = nap
Nepal Bhasa = new
Nepali = nep
Nias = nia
Niger-Kordofanian languages = nic
Nilo-Saharan languages = ssa
Niuean = niu
No linguistic content = zxx
Nogai = nog
North American Indian = nai
North Caucasian languages = ccn
North Germanic languages = gmq
North Ndebele = nde
Northern Frisian = frr
Northern Sami = sme
Norwegian = nor
Norwegian Bokmål = nob
Norwegian Nynorsk = nno
Nubian languages = nub
Nyamwezi = nym
Nyanja = nya
Nyankole = nyn
Nyoro = nyo
Nzima = nzi
Occitan = oci
Odiya = ori
Official Aramaic = arc
Ojibwa = oji
Old English = ang
Old French = fro
Old High German = goh
Old Irish = sga
Old Norse = non
Old Persian = peo
Old Provençal = pro
Omotic languages = omv
Oromo = orm
Osage = osa
Ossetian = oss
Oto-Manguean languages = omq
Otomian languages = oto
Ottoman Turkish = ota
Pahlavi = pal
Palauan = pau
Pali = pli
Pampanga = pam
Pangasinan = pag
Panjabi = pan
Papiamento = pap
Papuan languages = paa
Pedi = nso
Persian = fas
Persian = per
Philippine languages = phi
Phoenician = phn
Pohnpeian = pon
Polish = pol
Portuguese = por
Portuguese-Based Creoles and pidgins = cpp
Prakrit languages = pra
Pushto = pus
Quechua = que
Quechuan (family) = qwe
Rajasthani = raj
Rapanui = rap
Rarotongan = rar
Reunionese, Reunion Creole = rcf
Romance languages = roa
Romanian = ron
Romanian = rum
Romansh = roh
Romany = rom
Rundi = run
Russian = rus
Salishan languages = sal
Samaritan Aramaic = sam
Sami languages = smi
Samoan = smo
Samoyedic languages = syd
Sandawe = sad
Sango = sag
Sanskrit = san
Santali = sat
Sardinian = srd
Sasak = sas
Scots = sco
Scottish Gaelic = gla
Selkup = sel
Semitic languages = sem
Serbian = scc
Serbian = srp
Serer = srr
Shan = shn
Shona = sna
Sichuan Yi = iii
Sicilian = scn
Sidamo = sid
Sign languages = sgn
Siksika = bla
Sindhi = snd
Sinhala = sin
Sino-Tibetan languages = sit
Siouan languages = sio
Skolt Sami = sms
Slave (Athapascan) = den
Slavic languages = sla
Slovak = slk
Slovak = slo
Slovenian = slv
Sogdian = sog
Somali = som
Songhai languages = son
Soninke = snk
Sorbian languages = wen
South American Indian languages = sai
South Caucasian languages = ccs
South Ndebele = nbl
South Slavic languages = zls
Southern Altai = alt
Southern Sami = sma
Southern Sotho = sot
Spanish = spa
Sranan Tongo = srn
Standard Moroccan Tamazight = zgh
Sukuma = suk
Sumerian = sux
Sundanese = sun
Susu = sus
Swahili = swa
Swati = ssw
Swedish = swe
Swiss German = gsw
Syriac = syr
Tagalog = tgl
Tahitian = tah
Tai languages = tai
Tajik = tgk
Tamashek = tmh
Tamil = tam
Tatar = tat
Telugu = tel
Tereno = ter
Tetum = tet
Thai = tha
Tibetan = bod
Tibetan = tib
Tibeto-Burman languages = tbq
Tigre = tig
Tigrinya = tir
Timne = tem
Tiv = tiv
Tlingit = tli
Tok Pisin = tpi
Tokelau = tkl
Tonga (Nyasa) = tog
Tonga (Tonga Islands) = ton
Trans-New Guinea languages = ngf
Tsimshian = tsi
Tsonga = tso
Tswana = tsn
Tumbuka = tum
Tungus languages = tuw
Tupi languages = tup
Turkic languages = trk
Turkish = tur
Turkmen = tuk
Tuvaluan = tvl
Tuvinian = tyv
Twi = twi
Udmurt = udm
Ugaritic = uga
Uighur = uig
Ukrainian = ukr
Umbundu = umb
Uncoded languages = mis
Undetermined = und
Upper Sorbian = hsb
Uralic languages = urj
Urdu = urd
Uto-Aztecan languages = azc
Uzbek = uzb
Vai = vai
Venda = ven
Vietnamese = vie
Volapük = vol
Votic = vot
Wakashan languages = wak
Walloon = wln
Waray = war
Washo = was
Welsh = cym
Welsh = wel
West Germanic languages = gmw
West Slavic languages = zlw
Western Frisian = fry
Western Malayo-Polynesian languages = pqw
Wolaytta = wal
Wolof = wol
Xhosa = xho
Yakut = sah
Yao = yao
Yapese = yap
Yiddish = yid
Yoruba = yor
Yupik languages = ypk
Zande languages = znd
Zapotec = zap
Zaza = zza
Zenaga = zen
Zhuang = zha
Zulu = zul
Zuni = zun
