# English to Elvish
# eng to qya
# 1897 word pairs
# deliminator:  =
#
# DAMS - The Dictionary Additions Management System
# https://github.com/attogram/DAMS
#
# This work is licensed under the Creative Commons Attribution-Share Alike 3.0 Unported License.
# To view a copy of this license, visit http://creativecommons.org/licenses/by-sa/3.0/
# or send a letter to Creative Commons, 171 Second Street, Suite 300, San Francisco, California, 94105, USA.
#
I = jyet
Malarauko = Balrog
Uurime = August
Viiresse = April
a = ah
a = be
a = mine
abhor = feuya
abhors = feuye
abide = himya
abiding = sanda
abundance = uuve
abundant = uuvea
abyss = undume
account = quentale
actor = tyaro
actual = anwae
acute = laikae
add = onot
adhere = himyaa
adhering = himbat
adult = wea
adults = wean
aforementioned = yanae
after = ala
again = ata
agent = tyaroe
agile = tyelka
ago = yaa
agony = qualme
ahta = bite
ai = alas
air = wilma
airy = wilinae
akso = bone
ala = after
alas = ai
alcohol = suule
aldeon = avenue of trees
alive = kuila
all = ilya
allow = lav
alone = era
alphabet = tengwanda
alqua = swan
alya = prosperous
ananta = and yet
ancient = yaara
and = ar
angelic spirit = ainur
anguish = nwalme
animal = kelva
anwa = actual
april = viiresse
ar = and
are = toi
arm = ranko
army = hosse
arna = wounded
arrow = pilin
arrow shot = pilininge
arrows = pilindi
arwe = wound
as = ve
ascension = orosta
asleep = lorna
assemble = hostae
associate = otorno
at = back
at = thing
at = yallume
ata = again
ate = mata
auger = terett
august = uurime
autumn = yaavie
awake = kuilea
axe = pelekko
baby = lapse
back = atae
backwards = nan
bake = mastae
bakers dozen = yeen
bale = kalpae
ball = koron
balrog = malarauko
band = hossae
bang = rooma
bank = raava
bark = parmal
base = sundo
be = na
beach = falasse
bear = morko
beard = fanga
bearer = kolindo
beat = palpa
beautiful = vanya
beauty = vanesse
bed = kaima
bedroom = kaimasan
bee = nier
beget = ontaa
beginning = esse
begotten = nostare
bejeweled = sinquita
bell = nyelle
belly = kumba
beloved = meldae
below = nuun
bend = lungaa
beneath = und
bent = kauka
between = imbe
beyond = tare
big = alta
bird = wilin
birthday = nosta
birthmark = tiks
bite = nak
bites = nake
black = mori
black handed = morimaite
blackberry = piukka
blackness = moore
blade = hyanda
blades = hyandavar
blaze = uryuu
blessed = almaarea
blink = tihta
blinking = nienaita
bliss = almare
block = taapa
blocks = taapu
blood = serke
blossom = lokte
blot = motto
blow = pustae
blue = luune
boat = luntuu
bodily = sarkuvae
bold = kanya
boldness = verie
bone = akso
book = parma
border = reenu
both = yuuyo
bound = nautaa
bow = quinga
bow legged = quingatelko
bowl = salpaa
boyfriend = melindo
branch = olwa
brand = yulma
bread = masta
break = raaka
breaking wave = falmar
breath = suulae
breathe = suuya
breeze = wile
breezy = wilina
bridge = yantae
bright = kallasilya
brilliance = alkare
brilliant = alkara
broken = raakina
brooch = tankil
brood = luvu
brook = nelle
brother = onooro
brotherhood = otornasse
brotherly = torwa
brow = tirne
brown = varne
bud = tuima
buffer = taran
build = karae
building = ataquae
bull = tarukko
bump = yuna
burdensome = lumnaa
burly = poldaa
burn = urya
bush = tussa
but = eru
butterfly = wilwarin
by = ne
call = yello
candle = liikuma
canopy = telimbo
cape = mundo
carpenter = samno
carrier = kolindoo
carry = kola
cat = meoi
catch = atsa
cause = tyar
cave = rotele
cease = hauta
center = ende
channel = kelma
chant = lirae
charge = rimpa
cherry = pioe
chief = heera
child = seldo
child of valar = vanimo
children = seldovar
children of eru = eruseen
chilly = ringae
choke = quoroe
choked = quorint
chronicle = luumequenta
chronicles = luumequentavar
circle = rinde
circular = rinda
city = osto
clad = waina
clamor = nyalme
clan = nossuu
clasp = tangwaa
claw = rakka
claw fingered = rakkalepta
clean = poika
clear = lata
cleared = latina
cleave = hyary
cleft = hyatse
cliff = ollo
cloak = kollo
cloth = lanne
clothes = lannet
cloud = lumbar
clouds = lumbara
cobweb = ungweva
cobwebs = ungwevar
cold = ringa
collapse = atalta
collect = hosta
collide = crassna
collides = crassne
come = tulya
commander = kaano
commemorate = enyalet
commerce = mankale
compel = mauya
complain = nurra
complaint = nur
compulsion = mausta
computer = eputera
conceal = halyet
conch = hyalm
conquer = turme
consonant = surya
conspicuous = minda
construction = ataque
consumer = vaasa
contemptible = faike
continous = voron gandele
control = turya
copper = tambe
copper colored = aira
core = enda
corporeal = sarkuva
corpse = quelet
corpse candle = kaivokalmet
count = noota
countable = nootime
counted = nootina
countless = uunootime
country = nooria
course = tie
cover = tuupa
covering = telmet
covers = tope
crack = kiris
craft = kurwe
craftsman = tano
create = onta
creature = onna
crescent = kuune
crested wave = falma
cries = nalli
crooked = hwarin
cross = tara
crossbar = hwarma
crossing = tarne
crow = korko
crowd = rimbe
crown = rie
crowned = riina
cruel = nwalka
crumble = ruksa
crumbles = ruske
crumbling = ruste
cry = nalla
crying = nallat
cunning = finie
cup = yulmet
cupola = korominda
curved = kuuna
cushion = nirwa
cut = rista
dagger = sikil
dagger minded = sikahonda
damp = ringet
dance = lilta
dangle = linga
danian elves = pereldar
dare = verya
dark = nulla
dark vale = tumbo
darkness = lumbule
daughter = selde
dawn = aara
day = daana
daylight = aure
daytime = arie
dead = qualin
dear = melin
death = unquale
declivity = pende
decrepit = yernit
deep = nura
deep valley = tumbale
dell = nell
demon = rauko
deny = laly
depart = wanyaa
departed spirit = manu
descendant = indyou
describe = osteka
desert = erume
deserted = erdet
desirable = iirima
desire = iiret
destine = martya
destiny = maranwe
device = tanwe
devices = tanwee
dew = rosse
dexterous = formaita
direction = tia
dirty = waara
disappear = wanne
discolored = puurea
discussion = oquenie
disgust = feuyae
dish = vene
disordered = ruukina
distance = haiyasse
divine = valya
divinity = valasse
do = tya
doer = tyara
does = tyuu
dog = huo
dogs = huota
dome = koromindo
doom = ambarta
dot = tik
double = tatye
dough = makse
dove = kua
down = undu
downfallen = atalantea
downslope = pendee
downsloping = penda
dragon = fenume
dragons = fenumen
draught = yulda
draw = tuka
drawing = halme
dread = aista
dream = oloore
dreamy = oloorea
drink = sukya
drip = lipte
drop = limba
drowned = quorin
drowsy = lorda
dry = parka
dryad = nandin
dual = veru
dusk = loome
dusky = nully
dust = asto
dwarf = nauko
dwarves = nauken
dwell = mara
dwelling = noora
dwindle = piika
eagle = sorne
early = arinya
earth = kemi
earthen = kemina
east = roomen
eastern = roomenya
eat = mat
eating = matuu
echo = nallo
echoing = laamina
eddy = hwinda
edge = reenae
eera = principal
eight = tolto
elbow = ooleme
elephant = andamunda
eleven = minque
elf = quendel
elm = alalme
elves = quendelie
elvish = quendelian
ember = yuulu
empty = kumna
en = there
en = yonder
enchant = luhta
enchantment = luuke
end = metya
ending = tyelma
endless = oio
ends = metye
endurance = voronwie
endure = termara
enduring = voronwa
enemies = kotumuu
enemy = kotumo
enough = faarea
envelope = waya
equinox = tuilere
er = alone
er = one
escape = usii
escapes = usin
essa = young
esse = beginning
establish = tulkae
established = tulkan
eternal = oira
etymology = quettasundolie
evening = anduune
ever = voro
everlasting = vorima
every = nuttesa
evil = ulka
evil eyed = henulka
evil smelling = saura
exalted = varda
except = enga
excessive = liima
excessively = liime
expand = palyaa
expansive = palla
extend = paluu
extended = tainae
extension = taile
eye = hen
eyes = hend
faare = sufficiency
face = antu
fade = sintane
fade away = fifiira
fair = vanimaa
faithful = voronda
falasse = beach
fall = lantane
fallen = talant
fallen snow = losse
falling = lante
fallow = malwa
familiar = moina
family = nossu
fang = karkat
fanga = beard
far = haiya
far away = vahaiya
farea = sufficient
farewell = namaarie
fasten = take
fat = tiukaa
fate = ambart
fated = martae
father = atar
fathom = rangwe
fawn = marya
fear = kaure
feast = merendae
feather = quesse
february = neenime
feet = talwi
fell = helma
female = inya
fence = pele
festival = merende
festive = merya
feuya = abhor
field = peler
fiery = uuruva
fill = quanta
final = meetima
find = tuuva
fine = tereva
finger = lepta
fingers = leptavar
fire = uur
firewood = turu
firm = tulunka
first = inga
firstborn = estanesse
fish = lingwe
fit = maara
five = lempe
fix = tulku
fixed = tankat
flagstone = ambal
flame = naar
flame colored = kulda
flaming = urwa
flat = laara
fleece = ue
flesh = sarko
fleshy = sarqua
flies = wille
flint = tinga
flint hearted = tingahondo
float = lutu
flood = ulunde
flooding = uulea
floor = talan
floorboard = pano
flour = pore
flourish = rinke
flow = kelume
flower = loote
flowers = lootelot
flowing = siirima
flute = simpa
fluttering = wilwa
fly = wil
flying = rimpa
foam = falasta
fog = hui
folk = hos
follow = hilya
follower = hilde
fond = ser
food = apsa
foot = taal
footprint = runya
for = ten
for a long time = andoo
forbid = avaquet
foreign = ettelen
forest = taure
forever = ullume
forge = tamin
former = yana
fort = arta
forth = et
fortress = artan
fortunate = herenya
fortune = manar
foul = saurae
foulbellied = saurikumba
found = tuuvuu
foundation = talma
fountain = kektele
four = kanta
free = mirima
freeze = hilka
freezes = hilkin
frequent = rimba
fresh = wenya
freshness = ween
friday = ar nessaron
friend = nildo
friendly = nilda
friends = nildovar
from = ho
frost = ringwe
fruit = yaave
full = quantas
fun = ressutuu
fungus = hwan
galadriel = altariel
game = tyalie
gandalf = oloorin
gash = hyatsh
gate = ando
gather = sanga
geese = waani
germ = erde
giant = norsa
gift = anna
gimlet = teret
girlfriend = melisse
give = anta
giver = antoe
gives = antes
giving = ante
glass = hyelle
gleam = silda
gleaming = silde
glint = tinde
glinting = tinda
glitter = mirilya
glittering = rilya
glitters = mirilye
globe = korono
gloom = ungwa
gloomy = morna
glorious = alkarinqua
glory = alkaraa
go = wanya
goat = nyeene
goblet = suulo
god = ainatar
goes = wanyet
going = wanye
gold = malda
golden = laurina
golden red = kulda
goldleaf = laurealasse
gone = wanwa
gong = tombo
good = maar
goods = armar
goose = waan
gore = nasta
gorge = kilya
govern = tur
grade = tyelle
grades = tyellvar
grammar = tengwesta
grandchild = indyo
grant = lavae
grasp = mapa
grass = salque
grave = sapsa
great tree = taule
greed = milme
greedy = milka
green = laiqua
green elves = laiquendi
greenish blue = laiquaninwa
greenness = laiquasse
grey = sinda
grey elves = sindarinwa
grief = nyeere
ground = talami
growl = yarra
grumble = nuuru
guess = intyaa
gully = yaawe
gun = pinquesta
gust = suume
gyrate = hwinya
habit = haime
habits = haimevar
had = voita
hail = aaye
hair = lokse
half = perina
hall = oromarde
hallway = oromardeen
hammer = namba
hand = quaare
handle = mahta
handy = maite
hang = linger
happen = mart
happens = marta
happiness = valinese
happy = valina
harbor = koopas
harp = nande
harp music = oomalingwe
harp player = tyalangan
harp playing = salme
harper = nandaro
harping = nandele
harsh = naraka
harvest = yaavan
hasp = tangwa
haste = orme
hasty = orna
hate = moka
hateful = sanke
hatred = tevie
have = voi
haven = hoopa
having = voite
hawk = fion
head = kaar
heap = kumbe
hear = tena
hearing = lasta
heart = oorea
heat = uure
heave = amorta
heaven = menel
heavy = lumnet
hedge = karakse
heed = tir
height = taarie
heir = haryon
helmet = kassa
hem = riima
here = sinome
hero = kallo
hew = pelekta
hidden = halda
hide = loomy
high = taa
high tree = orne
highway = quanta malle
hill = tolmen
hillside = amban
hindmost = tella
historical = luumequentalea
history = luumequentale
hive = nierwes
hoard = foa
hobbit = tindera
hobbits = tinderavar
hole = assa
holes = assava
hollow = ronta
holly = piosenna
holy = aina
home = mar
homes = marae
homestead = osta
honey = nekte
hood = telme
hook = ampa
hooked = rempa
horde = horma
hordes = hormavar
horn = taru
horn of ulmu = hyalma
horned = tarukka
horse = rokko
horses = rokkuu
host = horma
hostile = kotya
hosts = horme
hound = huan
hounds = huanuu
house = kar
houses = kard
howl = naule
huge = uuveae
human = firya
humans = firyavar
humble = nukuu
humbled = nukumna
humpback = kauko
hunting = raust
husband = verno
ice = helke
icicle = helkelimbe
icy = helka
idea = intya
ideas = intyavar
idol = kordon
ill = laiwa
illuminate = kalya
ilya = all
imagination = intyale
imba = adhering
imbe = between
immortal = ilfirin
immoveable = tulkuu
impulse = hoore
imya = abide by
in = mi
incitement = suile
inclined = penda
include = panda
includes = pande
including = pandela
inge = trajectory
inhabited = ambaru
intellect = handele
intelligence = handasse
intelligent = handa
intense = saa
intensive = sa
interior = mitya
into = minna
intya = suppose
intya = supposition
invent = auta
invention = aule
inverted = nuquerna
ireland = iiwerin
iron = anga
ironclad = angaina
is = tou
island = tol
islands = tolle
isthmus = yatta
it = tu
january = narvinye
jaw = anka
jerk = rihtavar
jewel = sinko
jewelbox = oikta
jewels = sinqui
join = yan
joining = yanwe
journey = mesta
joy = alasse
juice = pirya
july = kermie
june = naarie
jupiter = morwen
kaima = bed
kainen = ten
kalpa = bale out
keen = laike
kelva = animal
kin = nossa
kind = nostale
kindle = tursa
king = harni
kingfisher = halatir
kiss = miquil
kisses = miquilis
kissing = misquila
knife = sikila
knob = tolos
knock = tamne
knocking = tamba
knoll = noola
knot = narda
know = ista
knowledge = isse
knowledgeable = istima
knows = iste
kolindo = bearer
kornen = ball
koron = ball
kuila = alive
kuile = being awake
labor = moota
ladies = herivar
lady = heri
laike = acute
laike = acuteness of perception
lake = ailo
lament = nyeena
lamp = kalma
land = kemii
language = lambe
lapse = baby
larch = fine
large = uura
lasselanta = late autumn
last = telwe
late = telwa
law = sanye
law abiding = sanya
lawn = palis
lay = lirilla
lead = kanu
leaf = lasse
league = laar
leagues = laare
leaning = talta
leap = halta
leap year = atendea
leaping = haloite
learned = istima
leaves = lassevar
left = hyarya
left behind = lemba
left handed = hyarmaite
leg = telko
lengthened = taina
lengthening = tailae
letter = tengwa
lick = sulp
lie = furu
lie down = kaita
life = kuile
lift = ruuma
light = kala
lighthouse = kalmindon
like = vae
linde = air
line = tea
lion = raavi
lioness = ravenne
lips = tannase
liquid = siirima
liquis = transparence
listen = lasta
little = tittu
lo = yee
loaf = korne
loathe = yelta
loathing = yelma
loathsome = yelwa
lofty = taara
lonely = eressea
long = anda
long and thin = lenwa
longing = maivoine
longsword = falquan
look = en
looking = ena
looks = ene
loom = windele
lord = heru
lords = heruvar
lords of the west = nuumeheruvi
lordship = heere
lore = nolwe
lorna = asleep
lost = wanwaa
lots = uuvee
lovable = melima
love = meles
lovely = melwa
loves = melesse
loving = nilda
low = numenda
lower = luvuu
luck = martee
lucky = marte
lump = tolos
lunte = boat
lust = maile
lustful = mailea
lyaa = yours
lyre = salma
machine = mahina
machines = mahinuu
made = karu
made of stone = sarna
magic = ingole
maiden = wende
maidens = wendevar
makar = tradesman
make = kara
male = hanu
malo = pollen
man = weo
manhood = wie
manka = trade
manly = weae
many = limbe
many leaved = lillassea
march = suulime
margin = reena
mark = tehta
marks = tehtavar
married couple = veruu
mars = karnil
mast = tyulma
masta = bake
master = heruu
mastery = tuuree
matrimony = vesta
may = kalainis
mead = miruvor
meadow = laire
meal = pore
mean = faika
measure = lesta
meat = apsaa
meet = omenta
meeting = omentie
melda = beloved
melodious = lindelea
melody = lin
memory = enyalie
men = weovar
mercury = elemmiire
mermaid = oar
mermaids = oarn
merriment = alasse
metal = rauta
mewing = miule
middle = endya
middle earth = endor
mighty = taura
minda = prominent
mine = one
mist = hiise
misty = hiise
mocking = yaiwe
moist = niite
monday = ar manwen
monster = ulundo
monsters = ulundovar
month = asta
months = astavar
mood = indo
moon = silmo
moonlight = isilme
moonstone = viirin
moore = blackness
morgoth = melko
morning = kale
mortal = firima
mortals = firimavar
mother = nana
mound = hahta
mountain = oron
mountain pass = falqua
mountain pool = ringe
mountains = oronvar
mountaintop = orto
mouth = anto
mouth of river = etsir
moving = tuuma
mumble = ulmu
mumbling = ulmula
murk = hui
murky = huiva
muscle = tuo
muscles = tuovar
muscular = polda
music = lindele
nail = takse
naked = helda
name = esta
nap = hautae
narrator = quentaro
narrow = arka
narrow path = aksa
nasal = nengwea
nation = nooru
native tongue = lambe
nature = ammasi
neck = yahti
necklace = firinga
nectar = miruvoore
need = maure
neptune = luinil
net = natsee
new = winya
new life = laisi
next = ento
night = loo
nightingale = loomelinde
nine = nerte
no = lala
nobleman = kallo
nobody = uuner
noise = ran
noldor = istimor
noldorin elf = noldo
noldorland = ingolonde
normal = sanya
north = formen
northern = formenya
nose = nengwe
not = uu
november = hiisime
now = sii
number = noote
numbered = hostain
numberless = avanoote
numenoorean = tarkildi
numerous = rimba
nuumenor = andoore
nymph = tavari
oak = norno
oaks = lindornea
oat = pole
oath = vanda
obliged = nauta
obscure = nuller
obscurity = mordo
occasion = luu
ocean = wai
october = narquelie
odor = holme
of = ess
ogre = sarquii
ogres = sarquindi
oh = a
ointment = laive
old = enwina
olden = yaarea
olwa = branch
ominous = lumnae
on = buu
on the other hand = naa
once = eryu
once upon a time = yaaresse
one = er
only = erya
open = latin
open mouthed = fauka
open wide = palya
opening = assat
oppressive = lumna
orange = kuluma
orc = orko
orcs = sankossi
order of wizards = heren istarion
orme = wrath
orosta = ascension
osse = army
osse = band
osta = assemble
osta = birthday
ostar = township
ostare = begotten
otorno = associate
out = ett
outer = eruumea
outerlands = ettele
outside = ette
oven = urna
over = vanwa
overcast = luurea
overshadow = telta
ox = taruku
oxford = taruktarna
pace = ranga
pain = nwalya
painful = naikelea
pale = iska
palis = sward
pansy = helin
parched = fauka
parchment = parmee
parent = ontaro
parents = ontani
parma = book
parma = writings
part = kirma
pass = kilya
pass away = waana
passage = tarna
past = wanwie
path = wand
peace = seere
peak = aikale
pearl = marilla
pebble = sar
pebble bank = sarnie
pelekko = axe
pen = tekil
people = nosse
permission = leneeme
person = noss
pic10a = tormenta
piercing = maika
pigeon = tuilindo
pile = hahta
pilin = arrow
pilininge = flight of arrow
pillar = tulwe
pillow = quesset
pillows = quessa
pin = tankila
pinque = thin
pipe = simpina
piper = simpetar
piping = simpise
pivot = peltas
place = men
plain = nanda
plait = finde
planet = nuvarish
planets = nuvarii
plank = pano
plant = olva
plants = olvuu
play = tyal
plenitude = faare
pliant = maksa
plough = hyar
ploughshare = hyandae
plum = pio
poem = lirit
point = tikse
pole = tulwe
pollen = malo
pool = kapalinda
poplar = tyulusse
poplars = lintyulussea
poppy = fuumella
possess = harya
possessing = arya
post = samna
potter = kemnaro
pour = ulyane
pouring = uulea
powder = malo
power = tuure
praise = laita
prayer = kyerme
press = sanga
preying = raust
prick = erka
prickle = erkat
prince = haryon
principal = heerae
profound = tumna
program = rithma
programming = rithmasse
programs = rithmavar
prolong = taita
prominent = minde
promise = weera
proper = vanimu
prosperous = alya
protect = varya
puff = hwesta
puff of air = hwesta
pull = tukalia
pure = poikae
pure white = faana
pursue = roita
putrid = sauray
qualme = agony
quarrel = kosta
queen = taari
quelle = late autumn
quentale = account
quenya = eldaquet
quiver = wainole
raava = bank
raava = river bank
race = noore
radiance = alkar
radiant = alkarinqua
rage = aha
raika = wrong
rain = miste
rainbow = helyanwe
raise = amut
randa = age
ranko = arm
ranqui = arm
rat = nyano
ravine = falqua
ray of light = alka
reach = rakta
real = anwa
realm = arda
rear = telle
reckon = not
red = karne
red breasted = karneambara
redwood = lairelosse
reed = liske
reek = usque
refuse = avaquet
region = meena
regular = sanya
reign = sanye
rejoice = valina
rejoice in redness = karnevalina
release = fainu
remains = erin
remember = enyala
rend = narki
rending = naraka
repeat = tatya
reply = nanquenie
repose = seere
resonant = tunga
rest = ser
resting = senda
return = entulesse
returned = antuulien
reversed = nuquerna
revolve = pel
rich = herenya
right = vanima
right hand = forya
right handed = formaite
rime = ringwe
ring = korma
ring day = kormare
rip = sakkata
rise = oro
rising = oore
rising tide = kelume
river = sindi
rivulet = siril
road = malle
roads = mallevar
roaring = raavea
robe = waima
robin = karneambara
rock = karka
rolling = nuuur
roof = toopa
roofed = telda
room = sambe
root = sulka
root word = sundoe
rose = tunulla
roses = tunulluu
round = korima
row = teema
ruddy = roina
rule = heru
run = nornoro
rune = kerta
rushing = arauka
safe = varna
sag = lunga
saga = lumenyaare
sagacious = finwa
sail = tala
sailor = oar
sails = talavar
salpa = bowl
samno = wright
sanctuary = yaana
sand = litse
sanda = abiding
saturn = lumbaru
satyr = tavaro
say = quet
scholar = istyar
scholars = istyarvar
scoop = kalpu
scorn = yaiwe
screen = telta
sea = earen
sea day = earenya
sea serpent = lingwilooke
sea spirit = falmarin
seagull = maiwe
seaweed = earuile
second = neuna
secrecy = muile
secret = foole
secretive = foolima
see = tupac
seed = erde
seen = tupaca
seize = mapa
send = horta
send for = tulta
sentence = quentele
september = yavannie
serpent = foalooke
set = nuuta
set up = tulk
setting moon = lanta raana
seven = otso
shade = loomin
shadow = fuine
shadowed = halda
shadows = fuinevar
shady = laira
shaggy = fasse
shake = rinka
shape = venie
sharp = laika
sheath = wainae
sheep = maama
shell = hyalmet
shepherd = mavar
shield = turma
shine = sisiila
shingle = sarnie
shining = faina
shining jewel = miril
ship = lunte
shore = hyapat
short = sinta
shortsword = eket
shot = inge
shoulder = rooma
shout = rambe
shrine = yaana
sick = kaimasse
sickle = kirka
sickly = engwa
sickness = quaame
sign = tehta
silmaril = noldomire
silpion = silmerosse
silver = silme
silver moon = silme raana
silvery = telemna
sindarin = sindarin
sinew = tuo
sing = lira
singer = lindo
singing = linde
single = eryaa
sink = nuuta
sip = salpu
sirius = nielliun
sister = onoone
sit = haara
six = enque
skilled = maite
skin = parmet
sky = teluumen
sky day = menelya
slash = kirisse
slave = mool
slay = maka
sleep = fuume
sleeping = loralya
slender = ninde
slope = talta
slow = lenka
slumber = murme
small = piinea
smith = tanee
smooth = nuuur
smouldering heat = yulme
smouldering wood = yuula
snake = ango
snare = neuma
snarl = yarra
snout = mundoo
snow = nique
snowflake = nieninque
snowlight = is
soap = lipsa
soft = maksa
soil = kemit
soiled = waaru
solar year = koranar
sole = talas
solitary = erda
solitude = eresse
somber = morna
son = yondo
song = lindele
songbird = lindo
soon = rato
soora = trailing
sound = lamma
soup = sulpa
south = hyarmen
southern = hyarmenya
sow = rer
space = ilmen
spark = tinta
sparkle = tintila
speak = quente
spear = ehti
spearhead = nasta
spearman = ehtyar
species = nostale
speed = horta
spelling = tenkele
spider = liante
spiderweb = ungwe
spike = nasse
spikes = karkaras
spindrift = winge
spine = erkau
spirit = fea
spit = puita
split = sanka
sponge = hwan
sport = tyalie
spot = men
spray = timpine
spread = palu
spread out = panta
spring = tuileere
sprite = nermi
sprout = lokta
staff = wandl
stain = waksee
stains = wahta
standard = tulwe
star = eel
starlight = ilma
starlike = elvea
starry = lintitinwe
starry twilight = tindoome
stately = airetaare
steadfast = tulkaya
steady = tulunka
steep = oronta
stem = telko
stick = olwenn
sticky = himba
stiff = tarya
still = eruu
sting = nasta
stirring = koire
stone = ondo
stonepiece = ambal
stoop = nuuta
stop = pusta
stopper = tampa
stops = taape
storm = raumo
stormy sea = haloisi
straight = teena
stray = ranya
stray about = mista
straying = raane
stream = kelume
street = malle
strength = poldore
stretch = lenn
stretch out = rakta
strider = telkontar
strip = helta
strong = tulka
strong place = sarne
successor = neuro
suffice = farya
sufficiency = faare
sufficient = farea
suffocate = quoro
summer = laire
summon = tulta
sun = ankale
sun maiden = aarien
sunday = anarya
sunlight = aare
sunrise = ambaron
sunset = anduunie
sup = salpa
super = nolda
support = tulko
suppose = intyae
supposition = intyaet
sure = tanka
surf = solosse
surface = palme
surge = solor
surrender = intu
swallow = luka
swallows = lintuilind
swan = alqua
swell = tuiya
swift = arauka
swirl = hwinya
sword = makil
sword blade = russe
swordsman = mektar
syrup = pirya
taita = prolong
tale = lumenyaare
talk = quet
tall = halla
tana = abovementioned
tangled hair = fasse
tanka = sure
tar = beyond
tarn = moile
tarya = tough
taste = tyav
taut = tunga
tear = niire
tears = nienaite
teary eyed = kilde
teenager = lassa
teeth = karkaras
teke = writes,he
teleri = falanyel
telerin elf = falmarin
tell = nyar
telmello telmanna = top to bottom
temple = korda
ten = kainen
tendril = liante
tengwanda = alphabet
tengwe = writing
tenkele = writing system
teret = auger
tereva = acute
terror = osse
thank = hanta
that = ta
thatch = tupse
the = i
them = dem
then = enyaare
there = enn
they = dey
thick = tiuka
thigh = tiuko
thin = pinque
thing = nat
thingol = sindo
think = noa
thirsty = fauka
this = sina
thither = tar
thorn = nasse
thorondor = sorontar
thrall = mool
thread = lia
three = nelde
threshold = fenda
throat = lanko
throne = mahalma
throng = sanga
through = tere
thunder = raumoo
thursday = ar fanturion
tie = nuty
tight = tunga
tilted = talta
time = luume
timid = kaurea
tin = latuuken
tinder = tusture
tinuuviel = tindoomerel
tiny = titta
tissue = lanna
tiuka = thick
tiuko = thigh
to = ana
together = om
tongue = quetil
tooth = karkae
top to bottom = telmello telmanna
torment = nwalya
torture = ungwale
tough = tarya
towards = an
tower = minas
town = osta
township = ostar
trade = manka
tradesman = makar
trail = runya
trailing = soora
trajectory = inge
transparence = liquis
traveled = lende
treasure = foa
treasury = harwe
tree = alda
tree shadowed = aldea
trees day = alduuya
treetop = amalda
tremble = tintila
tress = finde
triangle = neltil
tribe = hostar
tripping = norolinde
troop = hosset
troth = weere
true = anwaa
trumpet = hyoola
tube = roota
tuesday = ar ulmon
tuiya = swell
tulma = bier
tumna = profound
tune = linde
turned = querna
turret = mindon
tusk = karku
tuure = power
tuurin = tuurindo
twang = quingi
twelve = ratse
twilight = yuukale
twine = lia
twinkle = tintila
twinkling star = tingilinde
twitch = rihta
two = atta
tyalie = play
tyaro = actor
tyaro = agent
tyelka = agile
uinen = uinen
unbreakable = ilterendi
under = unda
underneath = nuune
understand = hanya
understanding = handa
undume = abyss
unfileable = ilterendi
unfurl = panta
ungoliant = ungoliante
ungwale = torture
universe = ilu
unquale = agony
until = mennai
up = amu
uphill = ambapenda
uprising = ambaron
upslope = ampende
upwards = amuu
uranus = neenar
urge = horta
urgency = horme
ursa major = otselen
us = wee
useful = maara
uulea = pouring
uuve = abundance
uuvea = abundant
vacuum = kuuma
vala = vali
valar = valaina
vale = nall
valiant = astaldo
valinor = aman
valley = nande
valor = kaane
vanesse = beauty
vanima = proper
vanished = wanwae
vanishing = uumea
varda = tintaanie
varied = lindoorea
varya = protect
vault = telluma
ve = as
veil = halya
veiled = halda
very = yanna
vessel = venet
victor = lakil
victory = tuurea
view = yeeta
vigil = tiris
vigor = laisi
vigorous = weate
vine = liantasse
violence = orme
violent = naraka
violet = nupappa
violets = nupappuu
virginity = weene
visible = valka
vision = maur
voice = ooma
void = lusta
vowel = amandi
wailing = quaine
waita = wrap
wake = koiva
wakening = kuivea
walk = vanta
wall = ramba
wall and moat = ossa
walled town = tiris
walme = torment
walya = torment
wand = olwen
wandering = raane
waning = quelie
waning moon = minga raana
want = merne
wanted = faare
war = ohta
warm = lauka
warrior = mahtar
warwick = kortirion
warwickshire = alalminoore
was = touun
wash = nuuda
watch = tiris
watchtower = tirion
water = linque
water meadow = nanda
water vessel = kalpa
waterlilies = neenuvar
waterlily = neenu
watery = nenda
wave = solme
wax = liiko
way = wande
waybread = koimas
we = ussa
wea = adult
wealth = alma
wealthy = herenya
wear = yerya
weather = luure
weave = lanya
web = natse
wed = vesta
wedding = vestale
wednesday = ar veruen
week = enquie
weeping = nierme
weft = lanat
went = vaa
werewolf = nauro
west = nuume
westa = puff
westa = puff of air
western = nuumea
wet = liquin
whale = uin
what = yo
wheel = norn
when = iire
where = mammen
which = yaya
while = wuulu
whining = miule
whirling = pirukendea
whirlpool = hwinde
whisper = lussa
white = ninque
white witch = kuruni
whiten = ninquitaa
whiteness = ninquisse
whither = mamment
who = ya
wicked = pisser
wide = landa
wide world = palurin
wield = mahta
wife = vesse
wild = merka
wilderness = raavae
wilin = airy
wilin = bird
will = benta
will-o-the-wisp = kaivokalma
willow = tasarin
wilma = air
wilya = air
wind = waa
wine = miru
wing = raama
winged = raamavoite
winter = hesin
winter child = heskil
wisdom = nolwe
wise = isqua
wish = mere
with = o
wither = hesta
withered = hessa
within = mii
without = ava
wizard = kuruvar
wizardry = kuru
wolf = narmo
wood = runda
wooden = turuuva
woodland = tavas
woodpecker = tambaro
woodpiece = pano
woof = winda
wool = too
woollen = toa
word = quent
worn out = yerna
would = benn
wound = harwe
wounded = harna
wrap = neppa
wrapped = neppesse
wrath = orme
wright = samnoo
writes = teke
writing = tengwe
writings = parmaa
wrong = raika
yaa = ago
yaa = formerly
yaara = ancient
yaavie = autumn
yaavieere = autumn equinox day
yallume = at last
yalp = yellp
yana = abovementioned
yanda = blade
yanta = yoke
yavanna = paluurien
yawn = haaka
year = yenya
yelle = bell
yellow = malina
yellow green = wenya
yerna = worn out
yet = ananta
yield = lavu
yoke = yanta
yonder = end
you = ly
young = nessa
yours = lyaa
youth = neese
youthful = nessima
zebra = na rokka
zebras = na rokku
