# Interlingua to Emoji
# ina to emo
# 18 translations
# deliminator:  =
#
# DAMS - The Dictionary Additions Management System
# https://github.com/attogram/DAMS
#
# This work is licensed under the Creative Commons Attribution-Share Alike 3.0 Unported License.
# To view a copy of this license, visit http://creativecommons.org/licenses/by-sa/3.0/
# or send a letter to Creative Commons, 171 Second Street, Suite 300, San Francisco, California, 94105, USA.
#
aure = ğŸ‘‚
ave = ğŸ¦
billet = ğŸ«
bucca = ğŸ‘„
familia = ğŸ‘ª
femina = ğŸ‘©
foco = ğŸ”¥
gelato = ğŸ¨
homine = ğŸ‘¨
lingua = ğŸ‘…
naso = ğŸ‘ƒ
oculo = ğŸ‘
pan = ğŸ
porta = ğŸšª
puera = ğŸ‘§
puero = ğŸ‘¦
stadio = ğŸŸ
traino = ğŸš†
