# Indo-European = Latin
# ine = lat
# 3573 Word Pairs
# delimiter: <SPACE>=<SPACE>
#
# Open Translation Engine 0.9.8.8
# http://indo-european.info/translator-dictionary/
# Thu, 30 Jun 2016 11:20:11 +0200 GMT
#
# This work is licensed under the Creative Commons Attribution-Share Alike 3.0 Unported License.
# To view a copy of this license, visit http://creativecommons.org/licenses/by-sa/3.0/
# or send a letter to Creative Commons, 171 Second Street, Suite 300, San Francisco, California, 94105, USA.
#
(dí)dōmi = dō
(gí)gnōskō (gnōwa) = nōscō
(ī́)wēmi = exhalō
(jí)jēmi = expellō
(kí)kōmi = exacuō
(pím)plēmi = pleō
(pím)prēmi = cremō
(s)úperi = super
(s)úperos = superior
(s)upmos = summus
(sí)stāmi = stō
(sí)stāmi antí/prāi = praestō
(sí)stāmi apó = distō
(wí)weimi = uēnor
(wí)wermi = inueniō
ábelos = malum
abhnós = repentīnus
abhro- = per-
acnos = agnus
ad = ad
adejō = praeparō
adghō = circumveniō
ādmi = siccō
admṇ = ritus
ados = ador
āghar = metuō
ágherom = lacus
aghjā = iūmentum
aghlós = repellens
aghlóws = irrorātiō
ághneumi   = affligō
agīnós = caprīnus
aglā = prōlēs
agm∂n  = agmen
agō = agō
agos = noxa
agós = ariēs
agrā = trucidatiō
ágrēnom = fructus
agróqolās = agricola
agros = ager
agslā = āla
agtós = actus
ág∂lis = agilis
aichesājō = pudet
aidhis = aedes
aidhō = ardeō
aigā = robus
aigros = aeger
aikō = ic(i)ō
áimneumi = imitor
aimom = effigĭēs
ainō = pertineō
áinumoi = potior
aiqos = aequus
airā = lolium
aisdai = honorō
aisdhom = ardor
aiskrós = clārus
aisō = reuereor
áisoskō = quaerō
aisskā = desiderium
aitis = pars
áiw(es)i = semper
áiwesos = aetas
aiwós = aeuus
áiwotāts = aetas
aiwu = uitālitās
ájeri = mane
ájesnos = aereus
ajos = aes
akējō = aceō
ákeris = acer
ákeswos = aceruus
akjēs = aciēs
akmā = buccella
akmōn = lapis
aknā = agna
áknāmi = edō
akōkós = acridium
akos = acus
akris = ācer
akrom = promontorium
áksijā = ascia
aksis = axis
aksteinos = genista
ákulos = aculeus
akus = acus
alā! = heus!
alājai = ambulō
albhos = albus
alchos = pecūnia
aldhōn = potārium
alēiks = alica
álesnos = alnus
alghējō = algeō
aljos = alius
áljote = aliō
alkejō = tueor
alkis = alcēs
alō = alō
alpos = paruus
álteros = alter
altjos = adultus
altós = altus
álumṇ = ceruisia
amāyō = amō
ambhí = circum
ambhíagtos = agens publicus
ámbhinom = circuitus
ambhíqolos = seruus
ambhírēmos = iter
ambhou = ambō
ámeikā = amīca
amēiks = amīcus
ámetā = amita
amghō = angō
amghús = angustus
ámghustis = angustiae
āmi = calefaciō
ammā = mamma
āmós = apprehensiō
amrós = amārus
āmros - āmrei = mane
amsus = creātōr
an = forsan
ana = ad
ándhesā = uirgō
andhos = caecus
anghwis = anguis
anglos = rotula
anjō = remoueō
ankos = ancus
anksi = anteluciō
ánksitjom = antelucānum
annā = anus
anos = anus
ansā = ansa
ansātos = ansātus
anta = uersus
antas = antae
antí = ante
ántijos = antiquus
ántitjos = classicus
antjās = antiae
antjom = fīnis
antrom = tugurium
anus = anus
an∂mos = animus
an∂ts = anas
apmṇ  = copula
apnis = amnis
apo = ab
apóqitis = represalia
ápōqos = āuersus
apóst∂tis = distantia
apóteri = post
apóteros = posterus
apowésentis = absens
ápowoiks = colonia
appās = pappa
apros = aper
āps = aqua
apsā = pōpulus tremula
apsos = membrum
aqā = aqua
ar = ergō
arājō = arō
árarjō = adaptō
arātrom = arātrum
árdejā = ardea
ardis = punctus
argis = albus
árgṇtom = argentum
argrós = splendidus
argujō = arguō
arjos = dominus
ármṇtom = armentum
armos = armus
arom = harundō
arqos = arcus
arti = adeō
artis = ars
artus = artus
árusā = abellāna
arwā = aruīna
arwom = aruum
āsā = āra
āsējō = areō
āsos = cinis
astris = astur
astus = astus
ati = re(d)
atiloiqos = reliquiae
atis = sparus aurata
atlos = nōbilis
ātmós = halitus
atnos = annus
ātō = respirō
atqe = ac
ātros = āter
attās = tata
audhos = dominus
augā́ = fascis
augējō = augeō
āugejō = augeō
augmṇ = augmentum
augō = augō
augos = auctum
augtós = auctus
aulos = conductus
auqslā = aula
ausijō = hauriō
ausom = aurum
ausōsā = aurōra
ausrom = matīna
áussketi = illūcescō
áusteros = orientālis
aw = autem
awā = fons
awējō = desiderō
áweljā = aura
awigsnā = auēna
áwijā = auia
awis = auis
awisdhijō = sentiō
awṇ  = fons
awō = pernoctō
áwontlos = avunculus
awos = auus
awou = retrō
awti = aut
awtim = autem
awtjos = destitūtus
ā́lujos = ālius
ā́peros = ripa
badjos = badius
baitā = falda
baktlom = baculum
bálbalos = barbarus
balbos = balbus
bámbalos = bombus
batā = locutiō sine sensu
baubājai = latrō
bebājō = bēbō
belom = uis
bélowents = robustus
bendā = extrēmum
bendlā = cnodax
bewō = imbuō
bhabhā = faba
bhāghus = bracchium
bhagjō = frigō
bhagō = addicō
bhagos = portiō
bhāgos = fāgus
bhalnós = pēnis
bhāmā = fāma
bhāmoi = for
bhām∂n = affāmen
bháneumi = illūminō
bhānis = sententia
bhānom = illuminātiō
bhānús = lucidus
bhāos = lux
bhar = far
bhardhā = barba
bharkos = fibula
bharseinā = farīna
bharsjom = pānis
bharwos = pīnus
bhaskis = fascis
bhāsos = ūltur
bhātis = expressiō
bhebhros = fīber
bhecō = currō
bhedhō = postulō
bhegō = arcuō
bheidhō = fīdō
bheikos = fīcus
bheiqlā = apēs
bheitlom = ascia
bheldō = battuō
bhelēks = fulica
bheljō = prosperō
bhelō = superluceō
bhelō = strepō
bhelu = dēbilitas
bhélunā = hyosciamus
bhemṛ = femur
bhendhō = ligō
bhendhros = collēga
bhendos = melodicus
bhenjom = contusiō
bherāgs = betulla
bherghō = conseruō
bherkō = fulgeō
bhermi (bherō) = bherō
bhermṇ = onus
bhernā = fissūra
bhersi = citō
bherwō = feruō
bhesmi = spirō
bheudhō = expergiscōr
bheughō = eueniō benē
bheugō = flectō
bheurō = commisceō
bhéwedā = compendium
bhewmi = sum
bhéwonom = reālitās
bhewtis = nātura
bhewtlom = circumiectus
bhíbheimi = timeō
bhidhós = fiscus
bhidrós = asper
bhilis = bonus
bhínāmi = tundō
bhindō = findō
bhītós = tusus
bhlādhrom = flābellum
bhlaghmṇ = flāmen
bhlagō = tundō
bhlaidos = candidus
bhlakkos = flaccus
bhlāmi = flō
bhledō = glorior
bhleicō = flīgō
bhleidō = inflor
bhlēmi = fleō
bhlendhos = sublustris
bhleucō = fluō
bhleugsmṇ = flūmen
bhleumi = dēbilitō
bhleusō = suffocō
bhḷgējō = fulgeō
bhḷkjō = fulciō
bhlokos = floccus
bhlōros = candidē maculātus
bhlōs = flōs
bhlosējō = floreō
bhloskos = scandalum
bhlōtis = flos
bhlōwos = flāuus
bhl∂gsmā = flamma
bhṇghus = crassus
bhodhjō = fodiō
bhodhwos = coruus
bhodjós = melius
bhodrós = excellens
bhodsā = fossa
bhogā = guerrilla
bhogājō = litigō
bhogjos = amnis
bhoglā = amnis
bhoidhos = foedus
bhoidos = foedus
bhoiqos = fūcus
bhokos = focus
bholghis = follis
bholjom = folium
bhōljóm = cubīle
bholos = uapor
bholós = strepitosus
bhondhsā = praesepēs
bhōr = fūr
bhorājō = forō
bhorcos = rudis
bhoros = gestāmen
bhorsos = superbus
bhosos = planipēs
bhoudhejō = expergefaciō
bhougā = fūga
bhougājō = fūgō
bhōwijós = propitius
bhragrājō = oleō
bhrātēr = frāter
bhrātreinos = sobrīnus
bhrā́trijos = frāternus
bhrēgō = luceō
bhreicō = frigō
bhremō = fremō
bhrendhō = exuberō
bhrenō = excellō
bhresjō = disrumpō
bhreugs = frux
bhreugsmṇ = frūmentum
bhreugtis = ūsus
bhreukō = mulceō
bhrēunā = līmes
bhreusō = tumefaciō
bhrēwā = pons
bhrewō = concoquō
bhrewṛ = puteus
bhṛghos = altus
bhrigijō = frigō
bhrijājō = friō
bhṛijō = incīdō
bhríkāmi = premō
bhṛkjō = farcio
bhṛksnos = frāxinus
bhṛktos = uarius
bhṛmā = incisiō
bhrṇgō = frangō
bhroigos = cacumen
bhrosdhos = cedrus
bhrounóm = squāma
bhrounos = spādix
bhroustom = frūstum
bhrówṇtis = frōns
bhṛstís = cuspis
bhṛtis = portātiō
bhrughnos = iuncus
bhrūgjai = fruor
bhṛugs = guttur
bhrūs = brus
bhrúsnāmi = defringō
bhrusnjā = lorīca
bhrusos = pectus
bhrustóm = particula
bhrutēks = frutex
bhrwtom = dēfrutum
bhudhmṇ = solum
bhudhnos = fundus
bhugjō = fugiō
bhugos = bestiola
bhukús = hebes
bhuljā́ = tumor
bhulkos = uigil
bhūm = fuī
bhúncai = fungor
bhusājō = osculō
bhūsjō = percurrō
bhūtā́ = mansiō
bhutjō = quatiō
bhūtós = part. pf.  esse
bh∂skō = pronuntiō
bh∂tjō = quatiō
bh∂wējō = faueō
bistlis = bīlis
blaktā = blatta
blatsājō = blaterō
blēkājō = bēbō
bṇdus = gutta
bodhrós = surdus
bokkos = caper
bólboljō = explōdō
bolkos = cuniculus
boukājō = personō
brenghos = raucus
brokos = mēlēs
bughōn = bubō
bukkā = bucca
cadhō = immergō
cāmṇ = gradus
cécālos = mundānus
cedhō = cruciō
cejwō = uīuō
cēlejō = tormentō
célṇdis = glans
celō = abiciō
celom = cauitās
célwonom = lauābrum
cemjō = ueniō
cenā = mulier
cerbhō = uorō
ceri = mons
cerjō = finiō
cerō = laudō
cerō = febriō
ceru = ueru
cérurom = berrum
césneumi = exstinguō
cespis = foliamen
cetus = bitūmen
ceudhos = immunditia
chaisos = pulcher
chedhō = rogō
cheldi = fel
chelō = desiderō
chendō = feriō
chenmi = interficiō
chentis = nex
cherō = calefaciō
cheros = calor
chislom = fīlum
chḷnō = fallō
chōks = fax
chonós = abundans
chormos = formus
chornos = fornus
chrensós = aestus
chṛjō = furō
cícāmi = abeō
cijā = ouīle
cínāmi = praeualeō
cīrós = laetus
cistis = digitus
cītā = uita
cīwāks = uīuax
cīwos = uita
cīwós = uīuus
cīwotos = animāl
cḷā = gula
cḷājō = uolō
cḷēnós = lassus
cḷnāmi = praepatior
cḷturós = uultur
cṃtis = itus
cobhōn = conglūtīnōsus
coinos = saccus
colbhos = uterus
corós = cibicida
cosdhos = uirga
cotejō = allūdō
cotlós = tumōr
coucis = merda
coudhros = immundus
cówijā = uanellus
cowijós = bouīnus
cówqolos = pāstor
cows = bōs
cowstā́s = bouīle
cṛ(āw)ús = grauis
cṛājō = uorō
crātós = grātus
cṛā́wenus = mola
cṛcestjom = gurgustium
cṛcots = gurgues
cṛebhos = foetus
creughos = maestus
croghos = adamī malum
crotsos = grossus
croughnos = maestitia
cṛús = grus
cr∂tos = brūtus
dā = certō
daimoi = distribuō
daitis = tempus
daiwēr = leuir
dakru = lacrima
dāmos = sodālis
dānus = fluuius
dápnāmi = carus esse
dapnom = impensa dapis
daps = daps
dáwētā = taeda
dáwetus = incendium
dáwneumi = accendō
dawtis = cibus ignis
dē = dē
debhō = depsō
dedrus = allergia
deghā = rihipicephalus
deikm∂n = exemplum
deikō = monstrō
deikos = directiō
deiktis = indicātiō'
deiwā = dea
déiwijos = dīuus
deiwos = deus
deiwotāts = deitās
deiwots = dīues
dekējō = decet
dekṃ = decem
dékṃtulos = digitus
deknos = dignus
dekos = decus
déksteros = dexter
deljō = calculō
delō = abiungō
demos = aedēs
denkō = admordeō
densō = dēdūcō
dentis = dens
derbhō = gyrō
derghō = cumulō
derō = sēparō
deru = lignum
deukō = dūcō
deuks = dux
deusō = ruinō
dew = procul
dhabhros = habilis
dhalnā = uiridia
dhanwos = abiēs
dhaunos = praedator
dhchínāmi = abeō
dhchitis = dēlētiō
dhebhō = abūtōr
dhechō = ardeō
dhēdhjos = auus
dhedhmós = consultus
dheghom = humus
dheghwis = inflammātiō
dheicō = figō
dhéicodhlā = fibula
dheimi = sūgō
dhejō = ponō
dhēlēiks = fēlix
dhēlgs = falx
dhēljos = lactans
dhelō = splendeō
dhēlós = tetta
dhēmṇ = habitus
dhemō = uaporō
dhenghō = imprimō
dhēnom = genitūra terrae
dhēnos = faenus
dherbhō = functionem incipiō
dherghnos = prūnus spinōsa
dherghō = corroborō
dherghos = rūber
dherghs = excrēmentum
dherkō = maculō
dhermi = retineō
dhēs = sacrificātiō
dhētis = factum
dheughō = sufficiō
dheukō = conterō
dheunos = fūnus
dhewō = currō
dhḗmonā = femina
dhghjesi = herī
dhghomōn = homō
dhghusā = perca
dhicsnis = fīnis
dhídhēmi-dh∂kjō = faciō
dhinghō = fingō
dhḷeghlā = dēbitum
dhṃelós = fundātiō
dhṃis = famēs
dhṃos = famulus
dhṇghus = directus
dhobos = solidus
dhochejō = foueō
dhochos = diēs
dhoighos = moenia
dholos = cauitas
dhombhos = columba
dhōmós = sententia
dhōnā = cereāle
dhóncelos = fuscus
dhoncos = obscūrus
dhónejā = uōla
dhontis = fons
dhorjā = diarhea
dhoubhos = surdus
dhoubhús = āter
dhoubnom = mundus
dhoulis = fūligo
dhōunis = fūnis
dhraghō = prōmō
dhreghō = circumcurrō
dhrēnos = gemitus
dhrensājō = drensō
dhreughō = militō
dhrighsós = fascis
dhṛmos = firmus
dhṛnumoi = saltō
dhroghnom = tornus
dhroghós = rota
dhṛsō = audeō
dhṛstis = audacia
dhṛsus = audax
dhrubhjō = comminuō
dhrubhtis = stilla
dhruslijō = dismontō
dhubús = profundus
dhugtēr = fīlia
dhūmājō = fūmō
dhūmós = fūmus
dhúneumi = agitō
dhuskos = fuscus
dhwerō = defraudō
dhwestus = pulicāria
dhwolnos = insānus
dhwolsā = uertex
dhwonos = sonitus
dhworis = foris
dhworom = forum
dhwosos = diabolus
dh∂tis = exhaustiō
dídēmi = ligō
dídjāmi = concipere
didkskō = dīscō
dighā = capra
djejō = moueō
djēws = diēs
djnos = diēs
dḷghējō = contineō
dḷkus = dulcis
dḷnghos = longus
dḷnghotā = longitudō
dṃpedom = locus operum
dṃpus = rudis
dṃseghṛ = dominium
dṇghwā = lingua
dṇsus = densus
dō = ad
dokejō = uideor
doklom = cauda
dolājō = dolō
dolejō = dīrumpō
dolghos = ros
dōljom = dōlium
dolos = dolus
dom = dum
dómāmi = domō
domos = domus
dómūnā = domina
dómūnos = dominus
dōnom = dōnum
dornom = manicula
doros = scissūra
dōsos = seruos
dōtis = dos
dounom = oppidum
dousmos = dūmus
dóusontos = braccium
drājō = laborō
drappos = drappus
drātis = labos
drātṓr = operārius
dṛdrājō = murmurō
dremō (dídrāmi) = currō
drepō = abscindō
dreughō = dēcipiō
drewā = cursus
drewō = consuēscō
drismós = asper
dristos = dūmus
dṛkjai peri = manifestor
dṛkjō = perspiciō
dṛkō = uideō
dṛkos = faciēs
dṛksmos = prospectus
dṛktā = lūmen
dṛktis = conspectus
dṛktis = uisus
dṛmijō = obdormiscor
dṛnós = fragmentum
dṛtis = scissiō
dṛtós = scissus
dṛwā = lolium
dsā = bellum
dumbos = caudula
dúnāmi = habilitō
dus = malē
dúsōpis = precārius
duswids = inscius
dweimi = timeō
dwenos = bonus
dwidkṃtói = uigintī
dwipods = bīpēs
dwīs = bis
dwīskos = pār
dwīsnōs = bīnī
dwoiros = dīrus
dwoplos = duplus
dwóteros = secundus
dwou, dwāu, dwou = duo
ēchṛ = pōtiō
ēchṛjos = ēbrius
ecnis = ignis
edhlos = ebulus
edhṛ = uallum
edjēw = hodie
edmi = edō
edqis, edqid = ecquis
edqos, -qā, -qod = ecquī, -quae, -quod
edunā = dolor
egējō = egeō
eghjos = er
eghṛ  = circunscriptiō
egō = egō
ei = ut
eibhō = futtuō
eikō = habeō
eimi = eō
eisā = ira
eisāskai = irāscor
eisom = gelū
ek(sí) = ex
eksoqs = inuisibilis
ekstar = longinquitās
éksteros = exterior
ékstṃos = extimus
ektós = praeter
ekwā = equa
ekwīnós = equīnus
ekwos = equus
ēlā = cuspis
elēn = alcēs
elkos = ulcus
elkós = malus
ellus = anguilla
elne elnā elnod = ille illa illud
elóm = gessī
elōr = olor
elwos = rosaceus
emō = emō
empis = insectus
en = in-
endo = in
endósēdjom = suppellex
enim = et
enīqā = faciēs
enis = quīdam
enkō prō = condūcō
ennós = interior
énsēdjom = insidiae
enslā = insula
enstar = proximitās
énteri = inter
énternos = internus
énterom = interuallum
énteros = interior
énteros = intestīnus
entós = intus
éperom = occidens
epi = insuper
épiromos = supernus
ercom = erūm
erjos = ariēs
erkō = commūnicō
ermi = requiescō
ermos = solus
ernos = arrectus
erō = erigō
éroros = aquila
erqō = splendeō
ersā = cauda
ersábhaljom = cauda
ersājō = errō
erwā = terra
esmi = sum
ēsmoi = sum
esos = erus
esṛ = sanguis
ēsús = bonus
éteros = secundus
eti = etiam
étiqe = etiam
etmṇ = animus
ētṛ = interior
ētros = uiuidus
eukō = colō
eusō = ūrō
ewō = induō
extrōd = ex
ḗpijos = adfīnis
gálgaljō = garriō
galnos = potentia
galnos = gallus
gangō = siffilō
gar = enim
garsijō = garriō
gāudhējō = gaudeō
gaudhjom = gaudium
ge = quīdem
geigō = acūtus sum
geimō = germinō
geisā = calculus
geltis = fētus
gelu = gelū
gemō = grauātus esse
gemros = gener
genesājō = generō
gengā = gingiua
genjos = sexus
genmṇ = germen
genos = genus
gentis = familia
gentlom = nascentia
gentṓr = genitor
gentrīks = genitrīx
gentus = genitus
genu = genū
genus = maxilla
gercō = cogō
gergō = contorqueō
gerjō = expergiscor
gerlós = senex
gerō = sēnēscō
gersā = gerra
gerwós = ueterānus
gesō = gerō
geulom = fauilla
geustis = gustus
gewō = resonō
ghabhlom = furca
ghabhros = hircus
ghaidīnós = haedīnus
ghaidos = haedus
ghaisējō = haereō
ghaisom = gaesum
ghaisom = pilum
ghaitā = capillum
ghálerom = labēs
ghanos = hiātus
ghansōr = anser
ghastā = hasta
ghawō = uocō
ghawōd = haud
ghebhlā = caput
ghedō = iunificō
ghei-ke ghāi-ke ghod-ke = hic haec hoc
gheidhō = aueō
ghéimentos = hiemālis
gheimṛ = hiems
gheimrīnós = hibernus
gheipō = hippitō
gheislos = obses
ghelbō = glorior
ghelijō = grunniō
ghelnom = labrum
ghelō = insecō
ghelus = testudō
ghelwos = olus
ghelwos = uiridis
ghēmi = perueniō
ghenghō = uadō
ghēr = ēr
gherdhō = circumdō
gherghros = siliqua
gherijai = desiderō
gherō = commodō
ghertom = butyrum
gherús = exiguus
ghesṛ = manus
ghesris = digitābulum
ghestos = manus
ghētis = aduentus
ghetlā = stīua
gheughō = obumbrō
gheusō = audiō
gheutis = fūtis
gheutlom = bacārium
ghéwejā = fouea
ghewos = spatium
ghi = certō
ghighējō = redeō
ghirrijō = hirriō
ghjājō = hiō
ghjems = hiems
ghlaghos = patibulum
ghlastos = caeruleus
ghlendhō = pertractō
ghleumi = nugor
ghloidos = sumptus
ghlōmi = renideō
ghloumos = nuga
ghḷtnós = aureus
ghḷtom = aurum
ghlustis = fluorescentia
ghṇdhus = cancer
ghṇdō = accipiō
ghneumi = mulceō
ghodos = pūga
ghoilos = alacer
gholwā = bald head
ghórdejom = hordeum
ghordhos = saeptum
ghorejai = hortor
ghornim = libenter
ghoros = intestīna
ghorsejō = horreō
ghortos = hortus
ghosdos = inedia
ghosóm = ēdī
ghóstipots = hospes
ghostis = aduena
ghouros = terrens
ghowejō = faueō
ghradjai = gredior
ghrāsmṇ = grāmen
ghrāsom = herba
ghrebhō = inhumō
ghrēdhus = fames
ghreibhō = captō
ghreim∂n = unctiō
ghṛējō = uacuus sum
ghremō = fremō
ghrendhā = corona
ghrendhos = cirrus
ghrendō = frendō
ghrēw = mane
ghrewō = conterō
ghrewō = ingruō
ghromos = fremitus
ghronos = signum
ghroudos = pila
ghrowā = calculus
ghudjō = damnō
ghundō = fundō
ghwerā = fera
ghwērīnós = ferīnus
ghwērós = ferus
ghwobhros = faber
gh∂bhējō = possideō
gh∂rtā = cuspis
gibbā = gibba
gígisai = accidō
gignō = gignō
gigrós = acūtus
gjewō = mandō
glabhō = ēfodiō
gladhros = glaber
glaghā́ = querēla
glakti = lac
glegos = infirmus
gleibhō = adhaerō
gleis = glis
glēkis = callidus
glembhō = inclūdō
gleubhō = glūbō
glínāmi = adhaerō
globhos = globus
glōghis = cuspis
gloidos = glūtinum
gloijós = glutinoosus
gloitṇ  = glūten
glokijō = glociō
glomos = glomus
glōs = glōs
glujō = glūtiō
gl∂gjēs = glaciēs
gnājō = gignō
gnāmi = adrōdō
gnās = prōlēs
gnāskai = nāscor
gnātós = nātus
gnebhis = uellus
gnebhō = uellicō
gneibhō = rādō
gneichō = nītor
gneidō = abrādō
gnōros = euidens
gnos = ingenuus
gnōsmi = agnoscō
gnōtis = nōtiō
gnōtlom = signum
gnōtós = nōtus
gnōtṓr = nōtor
gnoubhos = geniculum
gnōwos = nāuus
golbhnos = acūmen
gombhos = dentes
gomos = onus
gonējō = generō
gopos = fauces
gorbos = rūga
gorgnóm = tristitia
gorgós = tristis
goulos = buccale
gouros = turbidō
grakijō = gracillō
grammā = grāmiae
grānom = grānum
gṛbeinos = carpinus betulus
gṛbējō = rugātus sum
gṛbhō = charaxō
grebhos = rēte
gredō = scabō
gregs = grex
gremjom = gremium
grendjom = corōna
gretlom = cūnae
greubhō = mē āuertō
greugō = curuō
greumō = abrādō
greutō = solidificō
grṇdhís = grandis
grōbhos = quercus suber
grōdis = grandō
groumos = grūmus
grundijō = grunniō
grutis = lac passum
gudom = intestīnum
gugā = globus
gupā = pitheūs
gurnos = dorsum
gusnō = gustō
gutṛ = guttur
idhei = ibī
ikjō = ic(i)ō
ili = intestīnum
īljō = amandō
imde = inde
immō = immō
ipjō = opprimō
is, id = is, ea, id
īsarnom = ferrum
ita = ita
itājō = itō
itaqe = itaque
íteros = differens
itim = item
itṛ = iter
iwe = ceu
ī́nekmi = apportō
jagjō = uenerō
jāgjus = pius
jāi = certō
jālos = coniurātiō
jāmi = transeō
jāmi = iam
jáneumi = coniurō
jā́nuwā = iānua
jeghō = persequor
jegis = glaciēs
jekō = narrō
jekos = sānus
jēlom = desertum
jemō = contineō
jemós = geminus
jentēr = frāter patruēlis/ amitinus
jeqṛ = iecur
jesō = fermentō
jeunis = uia recta
jeus = ius
jewesdiks = iudex
jewō = adiuuō
jewom = hordeum
jéwornjom = cereāle
jewos = iūs
jṇdros = laetus
jṇtō = aueō
jod qid = quia
jodhei = ūbī
joinkos = iuncus
jom = cum
jomde = unde
joqe = et
jori = quapropter
jorkos = gazella
jōrom = tempus
jōrós = conspirātor
jos (je), jā, jod = is quis
jṓsneumi = cingō (to)
jota = quōmodo
jota sei = quasi
jóugsmṇtom = iūmentum
jówestos = iūstus
jucis = iūgis
judhejō = iubeō
jugóm = iugum
jungō = iungō
júwenis = iuuenis
juwes / juwe = uōs
juwṇkós = iuuenis
júwṇtā = iuuentus
juwōn = iuuenis
j∂kējō = iaceō
j∂kjō = iaciō
ka = sīc
kábṇlos = equulus
kabōn = equus
kadhō = praeseruō
kadō = cadō
kādos = cūra
kadros = sanctus
kaghlā = caula
kaghos = claustrum
kaidō = caedō
kaikos = caecus
kailom = augurium
kaipā = caepa
kairós = integer
káisṛjēs = caesariēs
kaisrom = capillum
kaitom = silua
káiwelos = exclusōrius
kákabā = perdix
kakkājō = cacō
kaklājō = cacillō
kákneumi = foueō
kakō = tenuefaciō
kaldējō = calleō
kaldos = callus
kalēiks = calix
kalgōn = cālīgo
kālis = macula
kalkis = calx
kalwos = caluus
kambos = tortus
kāmi = amō
kamō = comprimō
kampos = campus
kánāmi = fodiō
kandō = candō
kánkestos = equulus
kankus = ramulus
kanmā = crus
kanmṇ = carmen
kanō = canō
kantos = cantus
kaplos = instrumentum
kāpos = fundus
kaprā = capra
kapros = caper
kaput = caput
kareinā = carīna
karkar = mūnītūra
kárkarjō = nuntiō
karkros = cancer
karnājō = carinō
karōn = membrum
kāros = cārus
karpō = carpō
kárrēkā = rūpēs
kartús = dūrus
kasnos = cānus
kasterlom = castellum
kastra = castra
kastrājō = castrō
kastrom = forfex
katēsna = catēna
katsājai = congredior
katsājō = cōgō
kattā = fēlēs
katus = pugna
kaukos = collectāculum
kaulis = caulis
kaunós = pudendus
kawdō = cūdō
kawō = cūdō
káwonā = noctua
ke = hic
ke kā kod (eke ekā ekod) = hic hae hoc
kei = hic
keidō = descendō
keimēx = cīmex
keimoi = iaceō
keimos = colorans
keiros = obscūrus
kéiwijos = cīuīlis
keiwis = cīuis
kekājō = nectō
kekātrīks = cicatrix
kekō = saltō
kékuros = cicur
kēlā = cella
kēlājō = cēlō
keldō = percellō
kelgā = mysterium
kéliknom = cēnaculum
kelmos = galea
kelō = impellō
kélodhros = coluber
kēlom = sagitta
kelos = coopertūra
kelots = ephebus
kelsō = excellō
kelujō = iter facere
kelus = uia
kémelom = caelum
kémeros = lotus
kemjō = cantillō
kemō = adnītor
kemos = incornis
kenēs = cinis
kenkai = uacillō
kenklom = tendō
kenkō = pendō
kenkos = hamus
kenō = oborior
kentom = pannus
kentrom = centrum
kepō = infensō
keqō = mancillō
kérberos = mustela
kerdhjos = pāstor
kerdhō = ordinō
kerdhos = grex
kerdos = ars
kerkō = tenuescō
kerkos = gallīna
kernos = pāla
kernós = nix gelāta
kerom = caesariēs
kersnā = cēna
kersō = mutilō
kersṛ = caput
kerwos = ceruus
ker∂srom = cerebrum
kesdō = cēdō
kēsmi = reprimō
kesnus = ālius
kesō = pectō
kētjā = cubiculum
keubō = curuō
keudhō = abdī
keukō = inflectō
keulom = turgentia
keusō = locō
kēwējō = oscillō
khákhatnos = cachinnus
khamos = hāmus
khéderos = hedera
kighrós = agitātus
kikēr = cicer
kikjā = pīca
kiklēskō = inuocō
kiklós = frīgidus
kíkōnjā = ciconia
kīkus = mūsculus
kina = hinc
kingō = cingō
kintos = praecēdens
kippos = cippus
kirknos = circinus
kirkos = circus
kiskā = biceps
kistā = cista
kíteros = citer
kitōd = citō
kitrōd = citrō
kiwos = colōr
kī́keumi = uigescō
kjājō = diribeō
kjējō = ciō
klādis = clādēs
kladjos = gladius
klagjō = clangō
klāmājō = clamō
klambós = mutilus
klāmi = aggerō
klamrós = dēbilis
klāros = tabella
klārós = resonus
klāstis = conuocātiō
klaudos = claudus
klawdō = claudō
klawos = clāuus
klāws = clāuis
klawstós = clausus
kḷdis = callis
kḷdos = lignum
kleinos = acer
kleitis = casa
kleitrom = firmāmentum
kḷējō = caleō
kḷējō = nōminō
klepō = clepō
kleumi = audiō
kleumṇ = audītus
kléumṇtom = reputātiō
kleusō = oboediō
kleustis = oboedientia
kleutis = audientia
kleutō = sortior
kleutrom = historia
klewō = purgō
klewos = gloria
klínāmi = clinō
klisrós = gentilis
kḷjō = diuidō
kḷneumi = audiō
klṇgō = clangō
kloiwos = clīuus
klopnis = uallis
klounis = clūnis
kḷpros = cupa
kḷtos = calidus
klūtós = audītus
kluwējō = clueō
kḷwijō = difāmō
kmāmi = dēfetiscor
kṃertos = langusta
kṃros = camur
kṃti = cum
kṃtom = centum
knakos = glaesus
kṇjós = recens
knokos = ceruix
knouks = nux
kṇsējō = censeō
kṇstṓr = orātor
knuwā = nux
kobom = euentus
kodējō = turificō
koilús = sānus
kóilutāts = ualētūdō
koimā = pacta
koimos = cārus
koinos = hay
koinós = cognātus
koisā = cūra
koitús = modus
koksā = coxa
koksednīks = coxendīx
kolignos = canis
koljō = adhaerō
kolmṇ = culmen
kolmos = calamus
kolnis = collis
kolnom = sublīca
kolnos = unioculis
kolsos = collum
kólumbhos = columba
kom = cum
kómāglom = collectiō
kómjougos = coniunctiō
komjugs = coniux
kómmoinis = commūnis
kommoinitā́ts = commūnitas
komnom = congregātiō
kómnōmṇ = cognōmen
kómopjom = armāmenta
kōmos = globus
kómplēnos = complētus
kómsqṛtos = perfectus
kómtḷtis = patientia
komtrōd = contrā
kómwoirjom = curia
kómwoistis = conscientia
kōnājai = cōnōr
konkejō = combūrō
konkhā = concha
kōnos = turbēn
kophos = ungula
kopnos = portus
kóqros = immunditia
korbhis = corbis
koris = acarus
korjom = corium
korjos = exercitus
korkos = caenum
kormnos = aqua lixiuiae
kormōn = mustēla erminea
kormos = dolor
kornīks = cornīx
kornos = cornus
kṓrukos = saccus
korwos = raucus
kósolos = corilus
kostā = costa
koubos = artus
koupā = cūpa
koupnā = copia
koutā = mapālia
kowos = cauus
kowṛ = cauerna
krāmi = permisceō
krasi = cras
krāsrōn = crābrō
krātis = crātis
kratsos = crassus
kṛdḗn = cardō
kṛdhōn = carbō
kṛdi / kṛdjom = cor
kṛdijai = stomachor
kṛdjō = trepidō
kṛdsus = camisia
kréddhēmi = crēdō
kreidhrom = crībrum
kreimṇ = crīmen
kreitsō = agitor
krekō = texō
kremājō = cremō
krēmi = creō
kremom = ceruisia
krémusom = caepa
krenghos = anus
krenktis = cicātrix
krépāmi = crepō
krepō = praecipitor
krepús = fortis
krēqā = limēs
krēskō = crēscō
krētā = crēta
kretō = exsecō
kreugō = gemō
kreuks = crux
kreumi = dēpositō
kreupō = incrustor
kreutō = permoueō
krēwō = commoueō
krigā = clamor
krinō = crinō
kripsnis = crīnis
kripsos = crispus
kripstā = crista
kristājō = agitō
kritis = differentia
kṛjēs = cariēs
kṛklos = gracilis
kṛnāmi = corrumpō
kṛnos = corruptus
kṛnu  = cornū
krōbhtus = dēuotiō
krokijō = crociō
kroknos = peplum
krotjājō = agitō
krous = crūs
krowos = refugium
kṛpjos = calceus
kṛpos = corpus
kṛsējō = carreō
kṛsnos = āter
kṛsō = currō
kṛstus = cursus
kṛsus = currus
krustā = crustula
krūtis = cupula
kruwós = cruor
kṛwos = curuus
ksentis = sentis
kserós = siccus
ksnowātlā = nouācula
ksnujō = abrādō
ksūlom = columna
kúbāmi = cubō
kudājō = orbiurgō
kukulājō = cucu facere
kukūlós = cucūlus
kūlā = latebra
kūleks = cūlex
kūlos = cūlus
kumbhā = catīnus
kumbō = accumbō
kūmós = cumulus
kúnejos = cuneus
kupjō = exigō
kurnos = pulllus
kusdhos = thesaurus
kusis = basium
kūtis = cutis
kuwējō = grauidus sum
kuwos = catulus
kúwṛos  = potens
kwāimi = acquīro
kwatsos = caseus
kweidos = candidus
kwōn = canis
k∂pjō = capiō
k∂psā = capsa
k∂ptos  = captus
k∂sējō = careō
k∂stos = castus
k∂tos = catus
k∂wējō = caueō
labhō = emō
laghā = pāla
lāgō = ēlanguescō
laiwos = laeuus
lājō = obiurgō
lajos = adeps
lakertos = lacertus
lakus = lacus
lalājo = blaterō
lalu = pēnis
lāmā = lāma
landhom = sartagō
lāōs = lār
lāpos = bōs
lapsā = lampās
latēks = latex
latom = dies
lāurā = opus saxeum
lawō = fruor
lāwós = squadra
lawtlom = lucrum
lā́mṇtom = obiurgātiō
ledō = āmittō
leghō = occubō
leghos = fulcrum
leghskā = sēdēs
leghskós = pīger
leghtrom = destina
leghús = leuis
légneumi = ēguttō
legō = legō
legs = lēx
leibs = gutta
leidmi = permittō
leiglā = ligula
leigō = saliō
leiljom = liilium
leinō = uitō
leinom = līnum
leipā = tilia
leisā = līra
leitō = eō
leitos = litus
lembō = suspendō
lēmi = indulgeō
lemō = abrumpō
lemsos = phasma
lendhā = fons
lenghmi = dēclārō
lēnis  = lēnis
lentos = picea
lepō = balbutiō
lergos = plānus
lēsanks = ardesia
lesō = carpō
leswos = sublestus
lētis = indulgentia
letrom = corium
leubhos = cārus
léudheros = liber
leughō = mentior
leukō = luceō
leukós = lucens
leuks = lux
leuksmṇ = lūmen
lēumi = adflictō
leups = folium
lewis = falcula
ligājō = ligō
likējō = licēt
limpō = haereō
linghō = lingō
līnō = linō
līnós = litus
linqō = linquō
lipējō = adhaereō
lippā = lippa
liprós = adipōsus
litājō = litō
litwos = lituus
lṃbō = lambō
lṇcō = fatigō
lṇghros = leuis
lōbā = dēlictus
lodi = tarde
loghējō = dēpōnō
loghjom = situs
loghos = dēpositus
loigos = uitulus
loigós = lack
loimos = līmus
loiqnom = commodātus
loiqós = reliquus
loisā = līra
loisós = mitis
loksos = salmō
loksós = obliquus
loktos = culpa
londhom = regiō
londhwos = lumbus
longhros = lombrīcus
lordós = tortus
lorgā = uestigium
lorgos = uirga
lostos = hasta
loudis = laus
loughjom = sacramentum
lougos = rāmulus
loukejō = ilūminō
loukētjos = splendidus
loukos = saltus
loukós = splendor
louksā = fenestra
louksnā = lūna
louksos = lynx
lousēn = pedis
loutsā = merētrix
lowā = coma
lowō = lauō
lowtrom = lābrum
lubhējō = libet (mihi)
lubhjā = herba
lubhros = liber
ludhóm = iī
lugējō = fractus sum
lugjā = ōrificium
lugnós = flexibilis
lugtos = copiae
lukējō = luceō
lukskējō = incendō
lúnāmi = rumpō
lūnós = solūtus
lutom = lutum
lūtós = solūtus
luwō (lewō) = luō
luwō apó = absoluō
l∂bjom = labrum
l∂kesājō = lacerō
l∂kjō = laciō
l∂kós = lacerātiō
l∂nchijóm = pulmō
l∂pējō = plānus sum
l∂pods = lapis
l∂skējō = lascīuiō
l∂tējō = lateō
machos = iuuenis
machotis = iuuentūs
mághneumi = dēfendō
maghos = pratum
magō = configurō
mājō = mātūrō
mākājō = maciō
makēn = crumēna
mākesjā = mūrus
makrós = macer
mammā = mamma
mān = etenim
mānājō = mānō
mánnusos = homō
mānos = bonus
maqā = puella
maqos = ephebus
máreskos = mariscus
margōn = margō
mari = mare
markos = equus
masdos = mālus
mātējō = dēsignō
mātḗr = māter
māterós = solidus
mātérterā = mātertera
matlā = malleus
mauros = fuscus
mā́kōn = papauer
ṃbhros = imber
me = mē
mē = nē
medai = medeor
medgós = mergus
médhidjōws = meridiēs
medhjos = medius
medhu = mel
medjom = glans
médneumi = administrō
médodiks = medicus
mēdos = aestimātiō
meicō = mutō
meidō = desculpō
meidos = auctoritās
meilēts = milēs
meinom = propositiō
meitō = dēsum
meitrom = contractus
meiwijós = minor
mejājō = meō
mejnō = mūtō
mejō = mūtō
mejtis = permutātiō
mēknos = labrum
meldhjā = fulmen
meldhō = precor
melit = mel
meljom = milium
melkō = mulceō
melmṇ = articulus
melō = molō
melos = robustus
melsō = mentior
melwom = farīna
membhō = puniō
mēmi = metior
mēmsóm = carō
mendhai = interest
mendhō = torqueō
mendō = sūgō
mendom = mendum
menghos = frequens
mengō = uestiō
menis = phoxinus
menmṇ = intellectus
menos = sensus
mēnsis = mēnsis
mentā = uirga
mēqos = mōmentum
mercō = nigrō
mergā = furca
merghā = laqueus
mergis = situs
mergō = mergō
merkēds = naulus
merkō = fulgeō
mérneumi = turbō
meros = merus
mersō = inctercludō
merwos = insipidus
mesgō = communicō
meslā = merula
mestis = mensūra
mestós = mensus
mētā = mēta
meti = in mediā parte
mētijai = mētior
mētis = dīmensiō
metō = metō
metrom = mensūra
meudos = superbus
meugō = dēlūdō
meukō = ērōdō
meus / muskós = mūs
ṃgadhós = magnificus
mighlā = uapor
míkāmi = micō
miljom = minium
mimdō = accurrō
mímnāskō (memna) = memini
míneumi = minuō
minghō = mingō
mínusi = minus
misdhom = sālārium
misgā = sērum lactis
miskejō = misceō
mlājō = dēbilitō
mlākós = stultus
mlātóm = farīna
mḷdhos = permissīiuus
mḷdsnos = ēmollītus
mḷdus = mollis
mḷduwijō = molliō
mḷgājō = nuntiō
mlīnós = ēneruis
mḷjos = falsus
mḷkāmi = ēlanguescō
mḷnos = mulleus
mlōdhrós = excelsus
mlōskō = appareō
mḷsos = lentus
mḷwā = malua
mṇdōmi = mandō
mṇējō = maneō
mṇijai = ēmineō
mṇjō = opīnor
mṇkos = mancus
mṇkstrom = mixtarium
mṇsjai = intendō
mṇtijai = mentior
mṇtis = mens
mṇtō = mandō
mṇtom = mentum
mṇtos = mentiō
mṇtrājō = abrādō
mṇus = manus
mṇwos = insignificans
mō = sed
mōdos = constantia
modos = modus
moghjos = amoenus
moghō = possum
moghtis = potestās
moghtrom = remedium
moighos = uriina
moilos = comēs
moinijai = mūniō
moinis = mūnis
moinja = moenia
moisos = pellis ouīna
moitājō = mūtō
moitmos = grātes
moitwos = mutuus
mojnos = commūtātiō
moksi = mox
molā = mola
moldhā = occipitium
moldhos = prex
moleinā = molīna
mōlestos = mōlestus
molgējō = mulgeō
mōlis = mōlēs
moljā = lītus
mōlos = mōlimen
molpā = superbia
molqos = madidus
moltlom = malleus
mondō = ornō
mondós = cattulus
monejō = moneō
mongos = collus
monīli = monīle
monos = ceruix
montis = mons
morā = mora
morā = somnus terrorificus
morcós = obscūrus
mordējō = mordeō
morignā = mulier
morjods = poples
mórmoros = horror
morom = mōrum
mōrós = mōrus
moros = infortūnium
mōros = nōbilis
mōs = ingenium
mosgom = cerebellum
moukos = mūcus
mouros = illuuiēs
mousos = alga
moutos = mūtō
mowejō = moueō
mreghmós = caluaria
mṛējō = mereō
mṛghús = breuis
mṛijai = morior
mṛjos = pūbes
mṛkā = carota
mṛkējō = marceō
mṛkos = murcus
mṛktos = uarius
mṛmeikā = formīca
mṛmrājō = murmurō
mṛtājō = conterō
mṛtāsjom = mortārium
mṛtis = mors
mṛtos = mortuus
mṛwos = mortuus
mūdlom = dētersīuum
mūdnós = mundus
mudstos = mustus
mugijō = mugiō
munkō = ēmungō
mūs = mūs
muskā = musca
muskos = muscus
músnāmi = abdō
mūtrom = lutum
muttijō = muttiō
muttis = mutus
m∂dējō = madeō
m∂gis = magis
m∂glos = nōbilis
m∂gnán∂mos = magnanimus
m∂gnos = magnus
m∂gtājō = mactō
m∂rnamói = exspoliō
ṇ = in-
nantis = audacia
nāsis = nārēs
natrīks = natrix
nawāgós = nauta
nāws = nāuis
ṇbhudhnóm = abyssus
ṇcḗn = inguen
ṇdha = deinde
ṇdherós = inferior
ṇdhētós = infectus
ṇdhi = magis etiam
ṇdwojos = sincērus
nē = nē
nebhis = nūbes
nebhlā = nebula
nedis = urtīca
nedjos = propinquus
nedō = nōdō
nedsā = nassa
nedskō = nectō
neghō = penetrō
neghrōn = rēnis
nei = nequaquam
neicō = lauō
neidō = humiliō
neikō = ventilō
neitom = inimicitia
neiwós = dēpressus
nékāmi = necō
nekopīnós = necopiinus
neks = nex
némētom = sanctuārium
nemō = distribuō
nemos = nemus
nemots = inimīcus
nepēts = nepos
neptis = neptis
neqe = neque
neqid = nihil
neqis = nemō
neqom = nunquam
neqos = quisquis
neros = milēs
nérteros = inferus
nertos = robustus
nesros = modestus
ṇeu = sine
neudō = impendō
neukos = myops
new(ij)os = nouus
newājō = nouō
newṇ = nouem
néwṇos = nouenus (nōnus)
newō = nuō
newotāts = nouitās
ṇgnōtós = ignōtus
nī = sub
nijóm = dūxī
niktis = grānum
nínāmi = faueō
nīqos = prōnus
nisdos = nīdus
nitējō = niteō
nitjos = usitātus
nī́teros = inferior
ṇjousjom = iuiuria
ṇjoustos = iniustus
ṇkējō = necesse est
ṇkneumi = perueniō
ṇmrótijos = immortālis
nṃtos = plecāmentum
nṇkskai = nanciscor
nocējō = exuō
nócodos = nūdus
nōdos = nōdus
noibhos = sanctus
nōinos = nullus
nokejō = deleō
nom = num
nom nē = nonne
nōmṇ = nōmen
nōmnājō = nōminō
nomṛ = subtilitās
noqterinós = nocturnus
noqtis = nox
nosejō = recipiō
nōunā = esuriēs
ṇprobhwos = improbus
ṇqijētós = inquiētus
ṇserós = noster
ṇsis = ensis
ṇsloimis = illīmis
ṇsme = nōs
ṇswodhros = rārus
nū      = nunc
numki = nunc
ṇwidis = ignārus
n∂tis = natis
obhi = ob
óbrusjā = obrussa
ochis = lombrīcus
odáugjai = exulceror
odējō = olō
odhrom = claustrum
odjō (ōda) = ōdi
ōdjom = ōdium
odós = odor
oghlejō = inquietō
oghlos = molestia
ogmos = orbita
oidējō = tumeō
oighai = proficiscor
oimos = itus
óinoikos = ūnicus
oinos = ūnus
oinowṛstós = in eōdem tempore factus
oisjā = tēmō
oisos = iste
oitmi = appetō
oitos = sacrāmentum
oiwos = taxus
okējō = dubitō
ókētā = occa
ōkinós = compositus
okris = apex
oktōu = octo
oktowos = octāuus
ōkúpteros = accipiter
ōkús = rapidus
olejō = adoleō
olējō = aboleō
olgjā = cincinnus
ōlim = ōlim
oljoi oljāi olja = omnes
olmos = ulmus
ōlnā = ulnā
ólteros = ulterus
óltṃos = ultimus
oltrōd = ultrā
olwā = ulua
omos = firmus
ōmós = crūdus
omsos = umerus
onbhlos = umbilicus
onchis = unguis
oncṇ = unguen
oncō = unguō
oncōl = carbō
ondos = saxum
onējō = culpō
ónerjos = somnus
onghlos = clāuus
onjos = alius
onkājō = uncō
onkos = uncus
onos = onus
ónteros = secundus
ópitjos = ultimus
opjō = ēligō
opnā = substantia
ópopā = upupa
opos = opus
opos esti = opportet
ops = ops
oqō = uideō
oqos = oculus
ōrā = ōra
ōrājō = ōrō
orbhis = orbis
orbhjom = hērēditās
orbhos = orbus
ordhos = malleus
orgājō = contundō
orghis = pila
orghós = sollicitātus,
ormos = pauper
oros = mons
orús = altus
ōs = ōs
osbhos = nodus
osdos = rāmus
osēn = autumnus
oskos = frāxinus
ōsmi = aperiō
ósonos = ornus
ostis = os
ōstjom = ōstium
oucós = ūdus
oudṇ = terra
ougros = frigidus
ousis = auris
ṓw(ij)om = ōuum
owājō = ouō
owis = ouis
pādhlom = pābulum
pagos = pagus
pags = pax
pālājō = protegō
pálejā = palea
pálowos = pallidus
palpājō = tangō
pámponos = pampinus
pandos = pandus
panknos = pannus
pankō = tumescō
pannos = pannus
pāpeljos = pāpiliō
paplā = papula
pareikā = paelex
pārējō = pāreō
parkō = parcō
parsā = parra
pasknis = pābulum
pāskō = pāscō
pāsmi = attendō
pāsós = familiāris
pastos = fixus
pāstus = pastus
pau = paucum
paukos = paucus
paulos = paruus
pāwṛ = ignis
pedjós = dēterius
pedlom = sandalia
pedom = peda
pegtos = pectus
peidō = pinguescō
peigō = molestō
peikā = pīca
peikō = ornō
peikos = pīcus
peiks = pix
peimis = celer
peitus = resīna
pējō = insultō
pekō = pectō
pektēn = pecten
pektō = pectō
peku = pecu
peldō = pellō
pelkō = migrō
pelnis = pellis
pelō = lucror
pelom = superficiēs
pelsā = rūpēs
pelu = multum
pelupoikos = varius
pēlwis = peluis
pelwos = puluis
pēmṇ = dētrimentum
pendō = pendō
penō = cum fīlō laborō
penom = lūtum
penos = prouisiō
penqadkṃta = quinquaginta
penqdekṃ = quindecim
penqe = quinque
penqstis = pugnus
penqtos = quintus
pēnsús = saburra
pentō = indāgō
peqō = coquō
peqtis = coctiō
peqtós = coctus
peqtṓr = coctor
per(i), per(ti) = per
perijō = experiō
perístānom = religiō
perknā = tructa
pérkūnjom = mons
perṃós = absolūtus
perom = praeterea
peróm = plūma
peros = prorsum
pérperṇks = perperām
perqos = quercus
persā = calx
persnā = perna
persō = respergō
pertā = pertica
perti = altrinsecus
péruti = anno praeterito
pesdō = pedō
pesnis = pēnis
peterós = āla
pétḷos = petilus
petō = aduolō
petsnā = penna
petsnós = uolucrēs
peumi = intellegō
pewō = purgō
pibō = bibō
pigējō = molestus (esse)
pikrós = picans
pilos = pilus
pīmós = crassus
pinjos = baculum
pinkō = pingō
pinsō = pinsō
píperi = piper
pipjājō = pipiō
piptō = praecipitor
piskis = piscis
pitús = cibus
piwōn = pinguis
plabrājai = garriō
plākejō = suadeō
plākos = plānus
plākos = latus
plānos = plānus
plārom = contabulātiō
plātom = campus
plātús = latus
plautos = plautus
pḷdājō = plaudō
plēdhwis = multitūdō
plēis = plūs
plēistos = plūrimus
plējós = maior
plékāmi = plicō
plektō = plectō
plēmṇ  = plētūra
plēnós = plēnus
plētis = plētūra
pletjā = scapulae
plētós = plēnus
pleudō = inundō
pleumōn = pulmō
plewō = fluō
plighā = appendix
pḷmā = palma
pḷnamaí = appropinquō
pḷnāmi = pleō
plṇgō = plangō
plousmā = plūma
ploutos = tabula
plówijā = pluuia
plówijom = nāuis
plowós = ratis
pḷowós = albogiluus
pḷtáwijā = terra
pḷtnos = planitiēs
pḷtom = sagum
plúwaidhom = plumbum
pḷwods = palus
pṇdēks = pantex
pneusō = anhelō
pṇgō = pangō
pṇtō = pandō
podjom = podium
pods = pēs
poimēks = pūmex
pōimōn = pāstor
pojejō = inebriō
polis = urbs
polkā = ueruactum
polnēks = pollēx
polnō = cadō
polpos = pulpitus
poltos = puls
pondos = pondus
pōnom = pōtus
pontis = uia
poqós = coquus
porā = aer
porejō = asportō
porkos = porcus
pornós = plūma
porsis = bouuculus
porsōd = procul
portājō = portō
pos(ti) = post
pósteri = postea
pósteros = posterus
póstṃos = porstrēmus
postrōd = retrō
potējō = possideō
poti = uersus
potijai = potior
potis = dominus
pōtis = pōtiō
pōtlom = pōculum
potmos =  lātitūdo
potnjā = domina
pōtṓr = pōtor
pougā = pūga
poughos = uirginālis
pougnos = pugnus
pounā = turgentia
poutos = pēnis
powejō = purgō
póweros = puer
powros = pūrus
prāi = prae
práighesto = praestō
práiloghos = praesens
práinōmṇ = praenōmen
práiteri = praeter
prāmos = prīmus
pratis = filix
prāwos = prīmus
preistos = anterior
prējō = flabellō
prekō = precor
preks = prex
premō = premō
prepō = uideor
presō = premō
pretjom = pretium
pretō = percipiō
préwijos = anterior
prewō = pullulo
pṛgā = porticus
pṛijō = pariō
prijós = cārus
prījós = prīmus
prīskos = priscus
prīsmos = prīmus
prītis = delectātiō
prītós = delectātus
pṛkā́ = sulcus
pṛknos = uarius
pṛkskā = quaestiō
pṛkskō = poscō
pṛnāmi = uendō
pṛnos = praeteritus
prō(d) = prō
próbhoudhos = attentiō
probhwājō = probō
probhwos = bonus
prṓddōmi = prodō
prod∂tṓr = próditor
prōi = mane
proitis = profectiō
prokós = procus
prokos  = prouectus
promos = prīmus
proqēd = prope
proqos = propinquus
prósēdjom = beneficium
próstōrnos = extensus
prostos = tumulus
próteros = prīmus (a duobus)
proti = contrā
prōtós = attribūtus
prousijō = irritō
pṛptus = forma
pṛqos = uarius
pṛsnā = fragmentum
pṛsom = porrum
pṛstis = prominentia
pṛtis = pars
pṛtus = portus
prunsō = gelō
prúsneumi = rigō
pruswā́ = pruīna
pteljā = tilia
pujō = putēscō
pūjós = pius
pukos = cauda
pulgā = crīnis
pūlós = puter
pungō = pungō
pūpos = pūpus
pūrós = nucleus
pusbhis = pubēs
pusjō = inflō
puslēks = pūlēx
pustlā = pustula
pūtējō = pūteō
pūterós = puter
putlom = infans
pūtós = putus
puwējō = computō
puwos = pūs
p∂grós = constans
p∂gtós = pactus
p∂ra = iuxta
p∂ros = prae
p∂strom = pagina
p∂tējō = pateō
p∂tēr = pater
p∂terā́ = patera
p∂tjai = patior
p∂trjā = patria
p∂trjos = paternus
p∂trujós = patruus
p∂wējō = paueō
qād = quā
qālis = quālis
qām = quam
qāqos = quisque
qasjos = cista
qā́wṇtos = quantus
qdnos = magicus
qe = que
qedos = angulus
qedos = magia
qeisō = sentiō
qeistis = considerātiō
qejēskō = quiēscō
qejō = compōnō
qejtis = collectiō
qeklom = rota
qekō = prospectō
qeli = procul
qelō = uersor
qelos = caterua
qelpō = incuruō
qelsō = sulcō
qemō = uorō
qentos  = sacer
qerpō = reuertor
qésai = queror
qestis = pars
qidpe = quippe
qijētis = quiēs
qijētós = quiētus
qínumoi = uindicō
qíqeimi = aestimō
qis qid = qui quae quod
qisqis qidqid = quisquis quidquid
qṃdō = quandō
qṇtjō = patior
qodhei = ubī
qoi = quō
qoinā́ = ulciscātiō
qoinom = excrēmentum
qoitrós, koitrós = serēnus
qolkā = culcita
qolus = colus
qom = cum
qomde = unde
qondhros = angelica
qori = cūr
qorjom = catīnus
qoros = indolēs
qos qā(i) qod = quī quae quod
qostā = tussis
qot(j)os = quot
qota = ut
qote = quō
qóteros = uter
qotrēd = quō
qotrōd = unde
qṛeumi = gerō
qrínāmi = emō
qrītóm = emptus
qṛmis = uermis
qṛsnos = arbustus
qṛtus = uix
q∂ddrom = quadrum
q∂tjō = quatiō
q∂trus = quater
q∂trusnos = quaternī
q∂twṛádkṃta = quadrāgintā
q∂twṛádkṃtṃos = quadragēsimus
q∂twṛatnjom = quadriennium
q∂twṛdekṃ = quattuordecim
q∂twṛdjówijom = quadriduum
q∂twṛes = quattuor
q∂twṛkṃtémtṃos = quadrigentesimus
q∂twṛkṃtos = quadrigenti
q∂twṛpods = quadrupēs
q∂twṛtos = quartus
rādō = rādō
rāpom = rāpum
rārós = rārus
rastós = glaber
raudos = metallum
raukos = rudis
rāwos = rāuus
ṛdhjō = crēscō
ṛdhwos = arduus
rebhā = saltus
rebhājō = saltō
rebhō = tegō
rebhrus = conductus
recos = tenebrae
rēd/re = re(d)
regeinā = regīna
regjos = regius
regnom = regnum
regō = regō
regs = rex
regtós = rectus
reidhō = equitō
reidhos = facilis
reigō = alligō
reimā = rīma
rēimṇ = seriēs
rēis = rēs
reiwos = rīuus
rējō = rēmō
rekā = ricinus
rékneumi = ordinō
remō = requiescō
rēmoi = reor
rentus = possessiō
rēpō = rēpō
resgō = plectō
resgtis = restis
rēsmos = rēmus
rēti = colum
retō = currō
retrōd = retrō
reubō = abrādō
reudhos = rūfus
reudhos = rubōr
reudō = rūdō
reudos = rudis
reughmṇ = pasta
reugō = ructō
reumi = rūmorem faciō
reusmṇ = rūmen
reusmnājō = rūminō
rew = forās
réwesnā = ruina
rewis = planēta
rewmṇ = capillum
rewō = dēfringō
rewos = rūs
ṛghējō = sollicitō
rigjō = tormentō
ṛijai = orior
rikjō = ruinō
rínāmi = egerō
ṛkējō = arceō
ṛkēslom = repagula
ṛklā = arcula
ṛneumi = cieō
ṛnumái = capessō
ṛnutis = mōmentum
robhos = tectus
rōdhí = causā
rōdhjō = conitor
rōdō = rōdō
rōdos = alacer
roinos = agger
ros = ros
rōstrom = rōstrum
rotā = rota
ṛots = auriga
roudhstos = rōbīgō
roudos = plōrātus
rounā = secrētum
roupis = rūpēs
routos = intestīnum
rowā = cessātiō
ṛsjā = inuidia
ṛskai = eō
ṛtís = abitiō
ṛtkos = ursus
rudhējō = rubeō
rudhrós = ruber
rudhsós = rubeus
rudlós = rudis
rugijō = rugiō
ruktus = tunica
rumpō = rumpō
runkō = runcō
rupús = insincērus
ruspājai = rūspor
rwtós = rutus
r̥nāmi = dīuidō
r∂bhjō = rabō
r∂djom = radium
r∂gājō = rigō
r∂pjō = rapiō
r∂tis = ratiō
s(w)ei = sī
s(w)eike = sīc
sāgijō = sāgiō
sagom = sagum
saipis = saepēs
saitā = saeta
saitlom = saeculum
saiwos = saeuus
sājō = saeuiō
sákrodhokjom = sacrificium
sákrodhots = sacerdos
sakros = sacer
sal = sal
saldō = sallō
salēiks = salix
saleiwā = salīua
salom = salum
salús = immundus
samdhos = sabulum
sāmis = quiētus
samos = aestas
sām∂n = quiēs
sánāmi = satisfaciō
sáneumi = efficiō
sankijō = sanciō
sapos = succus
sasjom = messis
sātis = satiās
sauros = acerbus
sā́wel(jos)  = sōl
se = se
se/sos sā/sī tod = iste ista istud
sēd = sē
sēdājō = sēdō
sedējō = sedeō
sedējō ambhí = circumsedeō
sedlā = sella
sedm∂n = conditus
sedos = sēdēs
segēts = satiō
seghdhlā = buris
seghō = retineō
seghos = uictoria
seghurós = firmus
ségneumi = capiō
segnom = pedica
segō = serō
seikā = fustis
seilō = exstillō
seimā = uitta
seimṇ = secrētiō
seinus  = catēna
seiqō = effundō
sējdhlom = cōlum
sējō = cōlō
sékāmi = secō
sēknis = calmōsus
seks / sweks = sex
sekstos = sextus
sekūris = secūris
selgō = disparō
seljos = amoenus
selkō = sulcō
selō = emō
selom = domicilium
sēlom = sementis
selwā = possessiō
sēmi- = medius
semjō = excupāre
semli = semel
sēmṇ = sēmen
semos = ūnus
senchō = canō
senējō = seneō
senēks = senex
senqō = mergō
sentos = sēmita
sepēlijō = sepeliō
sépeltrom = sepulcrum
sepō = parō
septṃ = septem
séptṃos = septimus
seqai = sequor
seqi = aduersum
seqō = dīcō
seqos = separātus
serō = serō
serom = serum
sēros = sērus
sérpenos = serpens
serpō = serpō
sesmi = dormiō
sesqos = spartum
setis = uisitātor
sḗtjosi = sētius
seugō = sūgō
seutō = ferueō
sewājō = minuō
sewe = sui
séwijos = suus
sewō = permoueō
silējō = sileō
síneumi = ligō
sinísteros = idōneus
sinō = sinō
sinus = sinus
sisdō = sīdō
sísermi = fluō
sísghrāmi = olfaciō
síslāwos = benignus
sisō = serō
sisqos = siccus
sītús = sparsus
sjewm∂n = sūtūra
sjewō = suō
sjūdhlā = sūbula
sjūtós = sūtus
skabhjēs = scabiēs
skabhnom = scamnus
skabhō = scabō
skaiwós = scaeuus
skalpō = scalpō
skandō = scandō
skandslā = scāla
skāpos = manubrium
skatējō = scateō
skatō = scatō
skedō = dispergor
skegō = festīnō
skejō = luceō
skekō = irrumpō
skelō = debeō
skelos = scelus
skemō = uelō
skerbhō = excauō
skerdā = merda
skerdō = castrō
skerjō = scindō
skerō = exsultō
skeubhō = effugiō
skeudō = ēmittō
skeumō = obruō
skeuros = obscūrus
skeutō = operiō
skewō = inspiciō
skidjō = dēcernō
skijō = sciō
skindō = scindō
skīrós = clārus
skīwṛ = tībia
skḷiqā = siliqua
skḷjō = scindō
skḷneumi = deflectō
skṇgjō = claudicō
sknidā = ouum
skodhos = damnum
skoidos = lignum
skoirsās = scurrā
skoitom = scūtum
skojā = umbra
skolmā = columella
skōlos = ēlementum
skolpos = pluteus
skortom = scortum
skostrom = umbraculum
skotos = umbra
skouros = septentriō
skousā = pantalōnus
skreibhō = scribō
skreidō = caelō
skrobhis = scrobis
skroupos = scrūpus
skroutos = larua
skubtis = scapulae
skutājō = truncō
skūtos = operīmentum
slabai = labor
slagós = laxus
slakō = offendō
slatā = ferula
sleibō = prolabor
sleidhō = surrēpō
sleigō = explanō
sleimā = līma
sleimājō = līmō
sleimāks = cochlea
sleiwos = liueus
slējús = lēuis
sleubō = prolabor
sleugō = uorō
sligōn = ligō
sḷijai = saliō
sloidhos = massa
sloiwom = prunum
slougos = multitūdō
slṛgjō = lurcō
sṃ = cunctim
smā = certō
smalos = animal
smā́neumi = maculō
smegō = cupiō
smeidhō = caelō
smeighsli = mille
smeikā = mīca
smeirai = admīror
smeirātlom = mirāculum
smeiros = mīrus
smeitō = mittō
smejō = arrideō
smekslā = mentum
smelgā = agrostis
smelō = urō
smemorjā = memoria
smerdā = merda
smerdō = foeteō
smeros = mendum
smerwā = medulla
smeughō = fūmō
smitlā = macula
sṃlis = similis
sṃloghós = uxor
sṃoitis = concursus
sṃóp∂tōr = fraterculans
smoughos = angustiae
smoughos = fūmus
smudhnō = machinor
smúghneumi = irrēpō
snadhō = amputō
snāmi = nō
sneighs = nix
sneitō = dēminuō
sneitos = exiguus
snēmi = neō
snēmṇ  = nēmen
snerō = contorqueō
snētjā = intextus
sneubhō = nūbō
sneudhs = turbulentia
snēw∂r = mitra
sṇi = separātim
sníncheti = ninguit
snoghā = serpens
sṇstus = sensus
sṇtējō = cōgitō
sṇterí = absente
snusós = norus
sn∂ghjō = rēpō
sodejō = instituō
sōdjā = fūlīgō
sodjom = solium
sodóm = iī
sognos = retinaculum
soitos = uenēficium
sōlājai = sōlor
solkos = sulcus
solpos = oleum
solwos = tōtus
solwotāts = integritās
somejō = aequō
somós = aequus
sondhos = excrescentia
sontejō = mittō
sontis = sons
soqjos = socius
sorbhējō = sorbeō
sorbhos = sorbus
sormos = fluxus
sorwā = uiscus
soujós = sinister
soukos = sūcus
sówijā = sauia
spakos = gutta
spáneumi = extendō
sparos = sparus
sparwos = parra
speikā = spīca
speiksnā = spīna
speimis = tenuis
spekjēs = speciēs
spekjō = speciō
spelghā = lien
spelgis = asser
spelō = recitō
speltā = tabula
spēmi = extendī
spēnos = tetta
speqos = specus
sperdhō = certō
sperghō = festīnō
sperjō = spargō
spes = spes
speudō = accelerō
spingjā = passer
spjewō = spuō
spjonos = digitālis purpurea
spjwtos = sputus
spleidō = secō
spleighō = sēcēdō
splighstós = latus
spḷndējō = splendeō
spḷtājō = separō
spṇdō = coruscō
spoimā = spūma
spoisājō = spirō
spoisnā = halitus
spoljom = spolium
spondejō = spondeō
spondhā = lectus
spōnos = uirga
sponstós = sponsus
sportā = sporta
spoudā = coactus
spṛāmi = calcō
spreigō = abundō
spreudō = accelerō
sprewō = excitō
spṛgō = displōdō
spṛnō = spernō
spṛos = talus
sp∂ros = prosperus
sqalos = squalus
sqeros = prodigium
sqijā = spīna
sredhō = aestuō
sremsō = diffilor
srenkō = sternuō
srewō = fluō
srewtis = fluxus
srīgējō = frigeō
srīgos = frīgus
sṛijō = sarriō
sṛkijō = sarciō
srodhos = aestūs maritimī
sroknā = rostrum
srowmos = cursus
sṛpā = falcicula
sṛpijō = putō
sṛwājō = seruō
sṛwos = custōs
srwtom = fistula
stādhlom = stābulum
stagnom = lacus
stagō = remaneō
staknom = stagnum
stālos = solium
stāmṇ = institūtiō
stānējō = condō
stānom = locus
stārós = stābilis
stātlom = catasta
staurejō = instaurō
stauros = adminiculum
staurós = adminiculātus
stāwō = dētineō
steighō = ambulō
steipēts = stīpēs
steiwā = stīua
stejō = spissō
stejsjā = stīria
stelghō = dēfluō
stelō = pōnō
stelōn = stolō
stelpō = intueor
stembhō = conculcō
stemō = titubō
sterbhnjom = pellis sicca
sterbhō = decadō
stergō = amō
sterkō = coinquinō
sterkos = stercus
sterkos = stercus
sterlā = stella
sternom = intestina
sternós = rigidus
sterō = fūror
stérolis = sterilis
steros = stella
stērps = stirps
stertō = stertō
stertos = pinaculus
steugō = abigō
steumi = ēnuntiō
steupō = quatiō
steutō = sustineō
stigājō = instigō
stiprós = secūrus
stlāmṇ = lamina
stlātos = latus
stlītis = līs
stlokos = locus
stṃnos = truncus
stṇtējō = moror
stobhos = sublicā
stoghos = uara
stoighos = uia
stoipejō = stīpō
stolbos = uirga
stolgos = uis
stōmṇ = palātum
storejō = corrigō
stornjā = centrum
stoudjom = studium
stoupā = stūpā
strāmṇ = strām∂n
strātos = exercitus
strātós = strātus
streibā = linea
streidō = stridō
streigō = stringō
streigs = strīx
strengō = obstringō
strengom = corda
strēnwos = strēnuus
strepō = strepō
streubhō = acerbō
streudō = certō
strewō = sternō
strigājō = strigō
strigjā = stria
stringō = stringō
stṛneumi = sternuō
stṛnō = sternō
stṛnos = strātus
strudsmā = canna
strutjos = abauus
struwis = struēs
studējō = studeō
stupējō = stupeō
stupos = pālus
st∂tis = statiō
st∂tus = status
sū = benē
sudhjom = zythum
sujō = effundō
sūkós = porcellus
suljā = colluuiēs
súnoros = uiridis
sūnús = fīlius
sup = sub
supā = ius
supājō = iaciō
sūs = sūs
susājō = susurrō
susdos = siccus
sūtus = partus
suwids = doctus
swādejō = suādeō
swādús = suauis
swāi = sīc
swēdhskō = suēscō
swēdhus = mos
sweidō = flagrō
sweidos = sīdus
sweighlājō = sībilō
sweigō = oscillō
sweisdō = siffilō
swekō = fragrō
swekos = fragrant
swekrús = socrus
swékuros = socer
swelā = aprīcum
swelājō = uorō
swelāks = phoca
sweljos = familiāris
swelō = splendeō
swelom = traversa
swelplos = sulpur
swemōr = secūtus ueniō
swénāmi = sonō
swendhō = dēcrēscō
swepō = dormiō
swepṛ = somnium
swerbhō = gyrescō
swerghō = cūrō
swerō = susurrō
swērús = sērius
swerwos = transpuntorius
swesōr = soror
swesreinos = sobrīnus
swīnós = porcīnus
swoidājō = sūdō
swoidos = sūdor
swólejā = solea
swombhós = fungus
swonos = sonus
swōpijō = sōpiō
swoplom = everriculum
swopnjājō = somniō
swopnjom = somnium
swopnos = somnus
sworā = sūra
swordis = sordēs
sworēx = sorēx
sworos = pālus
swṛneumi = uulnerō
swrswrājō = susurrō
sw∂lējō = tumeō
s∂kesnā = sacēna
s∂ksom = saxum
s∂pijō = sapiō
tādējō = qualificō
tādhēskō = tābēscō
tādhis = tābēs
tagjō = ordinō
taismos = massa
tājō =  fūror
tājots = fūr
tálejā = talea
tālis = tālis
tām = tam
tarsós = uenter
tárudos = tardus
tātā = pappa
tauros = taurus
tausnim = silenter
tausos = silens
tā́wṇtos = tantus
tēglā = tēgula
tegnom = tignum
tegō = tegō
tegos = aedicula
tegtom = tectum
tegús = crēber
teibhjā = tībia
teknom = crātūra
tekō = accipiō
tekslā = secūris
teksnā = ars
teksō = fabricor
tekstā = testa
tekstlom = tēla
tekwō = ēcurrō
telmṓn = infula
telpō = locus mihi est
telsus = tellus
tembhō = contemnō
temesras = tenebrae
temkō = ēueniō
temlom = templum
temos = obscuritās
tēmos = ēbrius
tempos = tempus
tenā = taenia
tendō = tendō
tenghō = abstrahō
tengō = tingō
teni = tenus
tenjō = prolongō
tenjom = tempus
tenos = ligāmen
tensō = prōtēlō
tentrom = fūnis
tepējō = tepeō
tepnos = febris
teqom = trāiectiō
tercō = minor
téredhrom = terebra
tergō = tergō
tergslom = mantellum
terjō = teirō
termēn = terminus
terō = transeō
terpō = oblector
terptis = delectātiō
tersā = terra
tersai = serescō
térunos = tener
tetkōn = lignārius
tettā = tetta
téturos = pavō
teukmṇ = progeniēs
teukō = effodiō
teupō = genuflector
teurō = obtūrō
teusmṇ = cumulus
teusqa = desertum
teutā = populus
tewai = tueor
tewos = impetus
tibhjā = tibia
timējō = metuō
titijō = titiō
tkeimi = condō
tlāmi = resistō
tlātjos = patiens
tḷijō = requiescō
tḷnō = tollō
tloqai = loquor
tmāmi = secō
tṃpus = diffusilis
tm̥klos = lacte coagulātum
tm̥ktos = concrētus
tṇējō = teneō
tṇghus = obēsus
tṇgō = tangō
tṇtos = tentus
tṇus = tenuis
togā = toga
toi = profectō
tōkslos = bipennis
toksos = iuniperus
tokwós = fugax
tolājō = aduocō
tolkos = furfur
tom = tum
tom-ke = tunc
tomos = sectiō
tónāmi = tonō
tondejō = tondeō
tonejō = extendō
tongejō = opīnor
tonslis = tūlēs
tonstṓr = tonsōr
tóntenos = strepitus
tontrom = tonitrus
topnos = tepor
toqe = quoque
torcós = minax
tori = propterea
tórkmṇtom = tormentum
tormos = cnōdax
torós = penetrans
torpejō = delectō
torqejō = torqueō
torqis = torquēs
torsejō = torreō
torsmṇ = tonitrum
tot(j)os = tot
totrēd = eō
totrōd = inde
toughā = fortūna
touknā = perna
trabhis = trabs
traghō = trahō
traghsmā = trāma
trāntis = trāns
trebhō = habitō
tregsnos = audāx
treistis = tristis
trejes trija trísores = trēs
tremō = tremō
trenkō = incitō
trepō = perambulō
tresō = tremō
treudō = intrūdō
treughos = miser
treukō = abscindō
tríj∂tos = mare
triplós = triple
trípḷtis = triplicātiō
trĩs = ter
trisnôs = trīnī
tristis = testis
tritjos = tertius
trītós = trītus
tṛmēts = cuneus
tṛmos = tarmes
tṛnā = spīna
troghos = subolēs
trogjā = porca
trogos = porcus
tropos = uia
trosejō = terreō
troughi = uae
trowā = trua
trowō = corrōdō
tṛpējō = torpeō
tṛrpis = turpis
tṛsdos = turdus
tṛsējō = sitiō
tṛstis = sitis
tṛstos = siccus
tṛsus = siccus
trudskā = leprae
trudsmós = molestus
truks = interfector
tū = tū
tūljom = multitūdō
tumējō = tumeō
tumlós = tumulus
túmolos = tumultus
tundō = tundō
turgējō = turgeō
tūrjós = caseus
tursis = turris
tusjai = delector
tusnā = unda
tustijō = tussiō
tustis = tussis
twakos = armatūra
twenkō = compellō
twerō = amplexor
twoisós = uiolentus
twṛbhōn = turbō
twṛkos = aper
twṛmā = turma
twṛtos = uelox
t∂kējō = taceō
ucējō = ūmeō
ud = ex
úderos = úterus
ūdhṛ = ūber
ūdhros = ūber
ūdhús = immediātus
udsqe = insuper
ughḗn = collus
uksōn = bos
uksōr = uxor
ululājō = ululō
unksrā = umbra
upelos = malus
úperesū = optimē
uperi = super
úperos = superus
upo = sub
upóqrijom = interpretium
upósēdjom = fundamentum
upóstānom = seruitium
úpselos = altus
upsi = supra
uqnós = fornus
urús = amplus
ustós = ustus
uta = potius
wadhis = uas
wadhō = uādō
wadhom = uadum
wageinā = uagīna
wāghijō = uāgiō
wai = uae
wailos = humilis
wailós = lupus
wakkā = uacca
walgos = ualgus
walnom = uallum
walóm = mortus est
wapējō = nebulosus sum
waplājō = clamō
warnā = noctua
wāros = uārus
wāstos = uānus
wātis = uatēs
watjos = uatius
we = ue
webhō = texō
wédhneumi = ligō
wedhō = addūcō
wedhṛ = arma
wedhrom = tempus
wedhskō = caedō
wedmṇ  = locūtiō
wedō = narrō
weghjā = uia
weghō = uehō
weghtis = uectis
weghtlom = uehiculum
weghtṓr = uector
wegō = uegeō
wegō = texō
weidhō = dīuidō
weidos = praesentia
weidr̥ = bestia
weiks = domus
wéiktomā = uictima
weimṇ = textrīnum
weipō = inuoluō
weiros = fūnis
weis = uis
weisnā = uēna
weisō = fluō
weitēks = uitēx
weitis = uītis
weitō = incuruō
wéiwersā = uiuerra
wejes / weje = nōs
wekmi = desiderō
wekō = flectō
weksós = conuexus
weldō = uellō
welīks = armilla
welmi = uolō
welnā = unda
welnos = uellus
welō = uideō
welpō = expectō
weltis = uoluntās
wélwṃen = tegmen
welwō = uoluō
wélwtrom = inuolūcrum
wémāmi = uomō
wēmos = pulcher
wḗnāmoi = appetō
wendhō = oppugnō
wenēsnom = uenēnum
wenjā = familia
wenō = concupiscō
wenos  = amor
wenseikā = uensīca
went = praeditus
wentos = uentus
weqtis = rēs
weqtlom = dictus
wēr = forēs
werbos = flagellum
wereinā = secta
wergō = uergō
wergom = labos
weri = aqua
werjō = nōminō
wernā = betullla
wēros = uērus
werpō = ēuoluō
wersis = mās
wersmṇ = uerrūca
wersō = uerrō
werstidhlom = uestibulum
werstis = trames
wertm∂n = directiō
wertos = ualor
wertrom = dēfensiō
wérunos = cinctus
weskai = uescor
wēskō = exprimō
wésnāmi = instigō
wesnejō = negotior
wesnom = uēnum
wesō = maneō
wésolis = uīlis
wespros = uesper
wesṛ = uēr
wēsros = matina
westā = pulmentum
westijō = uestiō
westis = uestis
westos = daps
westus = domicilium
wēsus = excellens
wétāmi = uetō
wetlos = uitulus
wetos = tempus
wetsós = annucula creātūra
wetwos = uetus
wī = sē
wibrājō = uibrō
widā́ = appārentia
widējō = uideō
wídhewā = uidua
widhus = salīx
widjom = scientia
wigējō = uigeō
wijējō = uieō
wijēskō = uiēscō
wikis = uicis
wikjō = certō
wikkā = uenēfica
wíklutom = satis constans
wikwos = multifārius
windō = comperiō
windō peri = inuestigō
windos = appararens
winis = cable
winkijō = uinciō
winkō = uincō
winsō = causō
wīrós = uir
wisējō = uireō
wiskom = uiscum
wísogā = uirga
witājō = circumeō
wíteros = complementārius
wītjā́ = textus
witjom = curua
witus = cantus
wíweqmi = loquor
wḷbhontis = camēlus
wḷdā́ = conuiuium
wḷdhējō = imperō
wḷeiqos = liquor
wḷeisō = uerberō
wḷējō = ualeō
wḷepējō = lepeō
wḷeumi = diripiō
wlewā = leō
wḷghis = uallis
wḷiqējō = liqueō
wḷnā = lāna
wḷōrom = lōrum
wḷqos = lupus
wḷtis = caesariēs
wḷtus = adspectus
wṇdā = unda
wṇghējō = tortus sum
wochējō = uoueō
wodā = aqua
wodṛ = aqua
woghejō = addūcō
woghnos = uehiculum
woghos = uectiō
wogsmis = uomer
woida = sciō
woidejō = dirigō
woidlos = uīdulus
woidwṓs = conscius
woighos = ulmus
woikā = uigor
woikos = uīcus
woikós = peruicax
woikslā = uilla
woinā = poena
woinos = uīnum
woisos = uenēnum
woitā = uēnātus
wolējō = ēligō
wolgos = uulgus
wolmos = spīra
wolnos = uulnus
wolos = ēlectiō
wolós = uolens
wolpis = uulpēs
wolsom = perniciēs
wolwós = rotundus
wondhejō = torqueō
wondhos = caesariēs
wōnós = uānus
wopjā = aqua
wopsā = uespa
woqs = uox
worgjom = cannabis
wormis = uermis
wornos = color
worós = tresuir
wortejō = inuertō
wosejō = uestiō
wosis = tiara
wosmós = madidus
wospos = indūmentum
wṛaghmṇ = spīna
wṛdhom = uerbum
wṛdjā = rādix
wṛegis = clausūra
wṛeikā = rīca
wṛéikonjom = ricinium
wṛeinā = urīna
wṛējai = uereor
wṛēn = ueruēx
wṛeumi = claudō
wṛeumi apo = aperiō
wṛgā = uigor
wṛgējō = urgeō
wṛgjō = laborō
wṛgos = impetus
wṛijō = claudō
wṛisdējō = rīdeō
wṛnāmi = persequor
wṛṇgai = ringor
wṛonkā = manus
wṛonkis = fouea
wṛrādīks = rādix
wṛstā = pluuia
wṛstis = uersiō
wṛstos = uersus
wṛtō = uertō
wṛtom = saepimen
wṛughis = sēcale cereāle
w∂drā = lutra
w∂dris = uter
w∂gājai = uagor
w∂nskā = dēsiderium
w∂nskō = dēsiderō
w∂rbhis = circumductus
w∂rjō = accendō
w∂ros = uarus
∂gjō = aiō
∂gsājō = proclamō
∂gtis = contiō
∂pjō = apīscor
∂snātis = segēs
