# Indo-European = English
# ine = eng
# 3573 Word Pairs
# delimiter: <SPACE>=<SPACE>
#
# Open Translation Engine 0.9.8.8
# http://indo-european.info/dictionary-translator/
# Thu, 30 Jun 2016 11:17:13 +0200 GMT
#
# This work is licensed under the Creative Commons Attribution-Share Alike 3.0 Unported License.
# To view a copy of this license, visit http://creativecommons.org/licenses/by-sa/3.0/
# or send a letter to Creative Commons, 171 Second Street, Suite 300, San Francisco, California, 94105, USA.
#
(dí)dōmi = give
(gí)gnōskō (gnōwa) = know
(ī́)wēmi = blow
(jí)jēmi = expel
(kí)kōmi = sharpen
(pím)plēmi = fill
(pím)prēmi = burn
(s)úperi = over
(s)úperos = superior
(s)upmos = uppest
(sí)stāmi = stand
(sí)stāmi antí/prāi = advantage
(sí)stāmi apó = be-far
(wí)weimi = hunt
(wí)wermi = find
ábelos = apple
abhnós = sudden
abhro- = very
acnos = lamb
ad = at
adejō = prepare
adghō = beset
ādmi = dry
admṇ = rite
ados = spelt
āghar = fear
ágherom = lake
aghjā = plough-animal
aghlós = repellent
aghlóws = drizzle
ághneumi   = afflict
agīnós = goat
aglā = brood
agm∂n  = rank
agō = push
agós = ram
agos = fault
agrā = massacre
ágrēnom = fruit
agróqolās = farmer
agros = land
agslā = wing
agtós = pushed
ág∂lis = agile
aichesājō = feel-ashamed
aidhis = hearth
aidhō = burn
aigā = oak
aigros = ill
aikō = meet
áimneumi = copy
aimom = replication
ainō = belong
áinumoi = take-possession
aiqos = even
airā = ryegrass
aisdai = honour
aisdhom = ardour
aiskrós = clear
aisō = respect
áisoskō = request
aisskā = desire
aitis = part
áiw(es)i = always
áiwesos = period
aiwós = eternal
áiwotāts = eternity
aiwu = vital-energy
ájeri = early
ájesnos = brassy
ajos = brass
akējō = be-sharp
ákeris = maple
ákeswos = pile
akjēs = blade
akmā = bit
akmōn = stone
aknā = prickle
áknāmi = eat
akōkós = scammony
akos = chaff
akris = sharp
akrom = promontory
áksijā = axe
aksis = axle
aksteinos = broom
ákulos = sting
akus = needle
alā! = hello
alājai = stroll
albhos = white
alchos = money
aldhōn = trough
alēiks = spelt
álesnos = alder
alghējō = be-cold
aljos = another
áljote = place
alkejō = protect
alkis = roe-deer
alō = nourish
alpos = small
álteros = other
altjos = adult
altós = high
álumṇ = beer
amāyō = love
ambhí = around
ambhíagtos = public-servant
ámbhinom = circuit
ambhíqolos = servant
ambhírēmos = travel
ambhou = both
ámeikā = friend
amēiks = friend
ámetā = aunt
amghō = oppress
amghús = narrow
ámghustis = narrowness
āmi = heat
ammā = mother
āmós = seizing
amrós = sour
āmros - āmrei = morning
amsus = creātor
an = perhaps
ana = to
ándhesā = maid
andhos = blind
anghwis = snake
anglos = articulation
anjō = withdraw
ankos = hook
anksi = before-dawn
ánksitjom = before-dawn
annā = granny
anos = ring
ansā = handle
ansātos = handle
anta = towards
antas = portico
antí = before
ántijos = antique
ántitjos = classical
antjās = fringe
antjom = end
antrom = cave
anus = grandmother
an∂mos = breath
an∂ts = duck
apmṇ  = fastening
apnis = brook
apo = from
apóqitis = revenge
ápōqos = backward
apóst∂tis = distance
apóteri = behind
apóteros = hint
apowésentis = absent
ápowoiks = colony
appās = dad
apros = boar
āps = water
apsā = asp
apsos = limb
aqā = water
ar = therefore
arājō = plough
árarjō = adjust
arātrom = plough
árdejā = heron
ardis = point
argis = white
árgṇtom = silver
argrós = brilliant
argujō = reason
arjos = sir
ármṇtom = cattle
armos = arm
arom = reed
arqos = bow
arti = precisely
artis = art
artus = joint
árusā = hazelnut
arwā = butter
arwom = field
āsā = altar
āsējō = be-dry
āsos = ash
astris = hawk
astus = guile
ati = again
atiloiqos = remnant
atis = seabream
atlos = noble
ātmós = breath
atnos = year
ātō = breathe
atqe = and
ātros = black
attās = dad
audhos = sir
augā́ = glance
augējō = enlarge
āugejō = aument
augmṇ = increase
augō = increase
augos = development
augtós = grown
aulos = tube
auqslā = pot
ausijō = empty
ausom = gold
ausōsā = dawn
ausrom = morning
áussketi = dawn
áusteros = eastern
aw = howbeit
awā = fountain
awējō = desire
áweljā = breeze
awigsnā = oat
áwijā = grandmother
awis = bird
awisdhijō = feel
awṇ  = fountain
awō = spend-the-night
áwontlos = uncle
awos = grandfather
awou = back
awti = or
awtim = otherwise
awtjos = destitute
ā́lujos = garlic
ā́peros = shore
badjos = orange
baitā = skirt
baktlom = club
bálbalos = barbaric
balbos = tongue-tied
bámbalos = drum
batā = babble
baubājai = bark
bebājō = bleat
belom = strenght
bélowents = strong
bendā = end
bendlā = pintle
bewō = damp
bhabhā = bean
bhāghus = arm
bhagjō = fry
bhagō = atribute
bhagos = portion
bhāgos = beech
bhalnós = penis
bhāmā = rumor
bhāmoi = speak
bhām∂n = speech
bháneumi = illuminate
bhānis = sentence
bhānom = lighting
bhānús = bright
bhāos = light
bhar = wheat
bhardhā = beard
bharkos = brooch
bharseinā = wheat
bharsjom = bread
bharwos = pinetree
bhaskis = bundle
bhāsos = vulture
bhātis = expression
bhebhros = beaver
bhecō = run
bhedhō = require
bhegō = curb
bheidhō = trust
bheikos = fig
bheiqlā = bee
bheitlom = axe
bheldō = knock
bhelēks = coot
bheljō = enhance
bhelō = fluoresce
bhelō = make-noise
bhelu = weakness
bhélunā = henbane
bhemṛ = thigh
bhendhō = bind
bhendhros = mate
bhendos = melodious
bhenjom = hit
bherāgs = birch
bherghō = keep
bherkō = glimmer
bhermi (bherō) = bear
bhermṇ = burden
bhernā = breach
bhersi = quickly
bherwō = boil
bhesmi = blow
bheudhō = wake-up
bheughō = succeed
bheugō = fold
bheurō = knead
bhéwedā = profit
bhewmi = be
bhéwonom = reality
bhewtis = nature
bhewtlom = environment
bhíbheimi = fear
bhidhós = vessel
bhidrós = bitter
bhilis = good
bhínāmi = strike
bhindō = cleave
bhītós = struck
bhlādhrom = fan
bhlaghmṇ = priest
bhlagō = hit
bhlaidos = clear
bhlakkos = thin
bhlāmi = blow
bhledō = boast
bhleicō = hit
bhleidō = inflate
bhlēmi = weep
bhlendhos = dim
bhleucō = flow
bhleugsmṇ = stream
bhleumi = weaken
bhleusō = choke
bhḷgējō = shimmer
bhḷkjō = support
bhlokos = flake
bhlōros = white-stained
bhlōs = flower
bhlosējō = bloom
bhloskos = scandal
bhlōtis = flower
bhlōwos = yellow
bhl∂gsmā = flame
bhṇghus = dick
bhodhjō = dig
bhodhwos = scald-crow
bhodjós = better
bhodrós = excellent
bhodsā = grave
bhogā = guerrilla
bhogājō = contend
bhogjos = crook
bhoglā = stream
bhoidhos = ugly
bhoidos = ugly
bhoiqos = drone
bhokos = flame
bholghis = bag
bholjom = leaf
bhōljóm = den
bholós = noisy
bholos = steam
bhondhsā = crib
bhōr = thief
bhorājō = bore
bhorcos = rough
bhoros = worn
bhorsos = proud
bhosos = barefoot
bhoudhejō = awaken
bhougā = flight
bhougājō = flee
bhōwijós = favourable
bhragrājō = smell
bhrātēr = brother
bhrātreinos = brother's-son
bhrā́trijos = brotherly
bhrēgō = shine
bhreicō = fry
bhremō = grunt
bhrendhō = gush-up
bhrenō = edge
bhresjō = shatter
bhreugs = fruit
bhreugsmṇ = wheat
bhreugtis = use
bhreukō = strike
bhrēunā = limit
bhreusō = swell
bhrēwā = bridge
bhrewō = brew
bhrewṛ = well
bhṛghos = high
bhrigijō = chirp
bhrijājō = crumble
bhṛijō = cut-open
bhríkāmi = press
bhṛkjō = stuff
bhṛksnos = ashtree
bhṛktos = speckled
bhṛmā = incision
bhrṇgō = break
bhroigos = summit
bhrosdhos = cedar
bhrounóm = scale
bhrounos = brown
bhroustom = fragment
bhrówṇtis = forehead
bhṛstís = tip
bhṛtis = bearing
bhrughnos = bulrush
bhrūgjai = use
bhṛugs = throat
bhrūs = eyebrow
bhrúsnāmi = break
bhrusnjā = cuirass
bhrusos = breast
bhrustóm = particle
bhrutēks = bush
bhrwtom = syrup
bhudhmṇ = soil
bhudhnos = ground
bhugjō = flee
bhugos = animal
bhukús = blunt
bhuljā́ = swelling
bhulkos = watcher
bhūm = was
bhúncai = serve
bhusājō = kiss
bhūsjō = hasten
bhūtā́ = dwelling
bhutjō = hit
bhūtós = been
bh∂skō = pronounce
bh∂tjō = hit
bh∂wējō = be-favourable
bistlis = gall
blaktā = cockroach
blatsājō = chatter
blēkājō = bleat
bṇdus = drop
bodhrós = deaf
bokkos = goat
bólboljō = explode
bolkos = tunnel
boukājō = resound
brenghos = rough
brokos = badger
bughōn = eagle-owl
bukkā = mouthful
cadhō = dive
cāmṇ = step
cécālos = mundane
cedhō = torment
cejwō = live
cēlejō = torture
célṇdis = acorn
celō = throw-away
celom = cavity
célwonom = bath-tub
cemjō = come
cenā = woman
cerbhō = devour
ceri = mountain
cerjō = finish
cerō = praise
cerō = have-fever
ceru = pike
cérurom = watercress
césneumi = extinguish
cespis = branches
cetus = resin
ceudhos = rubbish
chaisos = beautiful
chedhō = pray
cheldi = bile
chelō = desire
chendō = wound
chenmi = murder
chentis = death
cherō = warm
cheros = heat
chislom = wire
chḷnō = deceive
chōks = torch
chonós = abundant
chormos = warm
chornos = hearth
chrensós = heat
chṛjō = be-violent
cícāmi = go-away
cijā = fold
cínāmi = prevail
cīrós = lush
cistis = finger
cītā = life
cīwāks = lively
cīwos = life
cīwós = alive
cīwotos = animal
cḷā = gullet
cḷājō = fly
cḷēnós = tired
cḷnāmi = agonise
cḷturós = vulture
cṃtis = march
cobhōn = viscose
coinos = sack
colbhos = womb
corós = big-eater
cosdhos = rod
cotejō = mention
cotlós = swelling
coucis = shit
coudhros = dirty
cówijā = lapwing
cowijós = bovine
cówqolos = herdsman
cows = cow
cowstā́s = ox-stall
cṛ(āw)ús = heavy
cṛājō = devour
crātós = welcome
cṛā́wenus = millstone
cṛcestjom = hovel
cṛcots = whirl
cṛebhos = embryon
creughos = sad
croghos = Adam's-apple
crotsos = big
croughnos = sorrow
cṛús = crane
cr∂tos = heavy
dā = certainly
daimoi = divide-up
daitis = time
daiwēr = brother-in-law
dakru = tear
dāmos = mate
dānus = river
dápnāmi = be-expensive
dapnom = feast
daps = banquet
dáwētā = torch
dáwetus = conflagration
dáwneumi = scorch
dawtis = fuel
dē = from-upwards
debhō = knead
dedrus = allergy
deghā = tick
deikm∂n = example
deikō = show
deikos = address
deiktis = indication
deiwā = goddess
déiwijos = godly
deiwos = god
deiwotāts = deity
deiwots = rich
dekējō = be-proper
dekṃ = ten
dékṃtulos = finger
deknos = worthy
dekos = virtue
déksteros = right
deljō = calculate
delō = split
demos = building
denkō = bite
densō = infere
dentis = tooth
derbhō = turn
derghō = get-cumulated
derō = separate
deru = wood
deukō = drag
deuks = leader
deusō = spoil
dew = far
dhabhros = skillful
dhalnā = vegetation
dhanwos = pinetree
dhaunos = predator
dhchínāmi = vanish
dhchitis = destruction
dhebhō = abuse
dhechō = burn
dhēdhjos = grandfather
dhedhmós = decree
dheghom = earth
dheghwis = inflammation
dheicō = puncture
dhéicodhlā = brooch
dheimi = suck
dhejō = put
dhēlēiks = productive
dhēlgs = scythe
dhēljos = baby
dhelō = shine
dhēlós = teat
dhēmṇ = condition
dhemō = steam-up
dhenghō = press
dhēnom = farm-produce
dhēnos = interest
dherbhō = start
dherghnos = sloe
dherghō = strengthen
dherghos = red
dherghs = shit
dherkō = stain
dhermi = retain
dhēs = duty
dhētis = fact
dheughō = be-enough
dheukō = destroy
dheunos = death
dhewō = run
dhḗmonā = female
dhghjesi = yesterday
dhghomōn = human-being
dhghusā = perch
dhicsnis = end
dhídhēmi-dh∂kjō = do
dhinghō = model
dhḷeghlā = debt
dhṃelós = foundation
dhṃis = hunger
dhṃos = employee
dhṇghus = direct
dhobos = solid
dhochejō = make-hot
dhochos = day
dhoighos = wall
dholos = hollow
dhombhos = dove
dhōmós = opinion
dhōnā = cereal
dhóncelos = dark
dhoncos = dark
dhónejā = hollow
dhontis = fountain
dhorjā = diarrhea
dhoubhos = deaf
dhoubhús = black
dhoubnom = world
dhoulis = soot
dhōunis = strick
dhraghō = bring-out
dhreghō = run-around
dhrēnos = roar
dhrensājō = cry
dhreughō = military-service
dhrighsós = bundle
dhṛmos = steady
dhṛnumoi = jump
dhroghnom = potter-wheel
dhroghós = wheel
dhṛsō = dare
dhṛstis = boldness
dhṛsus = bold
dhrubhjō = crumble
dhrubhtis = drop
dhruslijō = dismantle
dhubús = deep
dhugtēr = daughter
dhūmājō = smoke
dhūmós = smoke
dhúneumi = agitate
dhuskos = dark
dhwerō = deceive
dhwestus = fleabane
dhwolnos = crazy
dhwolsā = whirlpool
dhwonos = sound
dhworis = door
dhworom = courtyard
dhwosos = demon
dh∂tis = exhaustion
dídēmi = tie
dídjāmi = conceive
didkskō = learn
dighā = goat
djejō = move
djēws = day
djnos = day
dḷghējō = maintain
dḷkus = sweet
dḷnghos = long
dḷnghotā = length
dṃpedom = building place
dṃpus = rough
dṃseghṛ = domain
dṇghwā = tongue
dṇsus = thick
dō = to
dokejō = seem
doklom = tail
dolājō = cudge
dolejō = disrupt
dolghos = dew
dōljom = barrel
dolos = fraud
dom = still
dómāmi = tame
domos = house
dómūnā = landlady
dómūnos = landlord
dōnom = gift
dornom = wrist
doros = rent
dōsos = slave
dōtis = dowry
dounom = town
dousmos = bush
dóusontos = arm
drājō = work
drappos = drapery
drātis = work
drātṓr = workman
dṛdrājō = murmur
dremō (dídrāmi) = run
drepō = cut-out
dreughō = beguile
drewā = course
drewō = treat
drismós = harsh
dristos = bramble
dṛkjai peri = be-visible
dṛkjō = make-up
dṛkō = see
dṛkos = vision
dṛksmos = perspective
dṛktā = light
dṛktis = view
dṛktis = seen
dṛmijō = fall-asleep
dṛnós = split
dṛtis = split
dṛtós = split
dṛwā = ryegrass
dsā = war
dumbos = tail
dúnāmi = arrange
dus = bad
dúsōpis = precarious
duswids = incompetent
dweimi = fear
dwenos = good
dwidkṃtói = twenty
dwipods = biped
dwīs = twice
dwīskos = matching
dwīsnōs = two each
dwoiros = fearful
dwoplos = double
dwóteros = second
dwou, dwāu, dwou = two
ēchṛ = drink
ēchṛjos = drunken
ecnis = fire
edhlos = elder
edhṛ = palisade
edjēw = today
edmi = eat
edqis, edqid = someone
edqos, -qā, -qod = some
edunā = pain
egējō = lack
eghjos = hedgehog
eghṛ  = boundary
egō = I
ei = that
eibhō = fuck
eikō = have
eimi = go
eisā = wrath
eisāskai = be-angry
eisom = ice
ek(sí) = outside
eksoqs = invisible
ekstar = remoteness
éksteros = external
ékstṃos = outermost
ektós = excepted
ekwā = mare
ekwīnós = of horses
ekwos = horse
ēlā = bodkin
elēn = red-deer
elkos = wound
elkós = bad
ellus = eel
elne elnā elnod = that
elóm = conducted
elōr = swan
elwos = pink
emō = take
empis = insect
en = in
endo = inside
endósēdjom = furniture
enim = and
enīqā = face
enis = certain
enkō prō = drive
ennós = interior
énsēdjom = ambush
enslā = island
enstar = proximity
énteri = between
énternos = internal
énterom = interval
énteros = internal
énteros = intestine
entós = inside
éperom = west
epi = on
épiromos = on-top
ercom = pulse
erjos = ram
erkō = share
ermi = rest
ermos = abandoned
ernos = upright
erō = heave
éroros = eagle
erqō = shine
ersā = tail
ersábhaljom = tail
ersājō = wander
erwā = land
esmi = be
ēsmoi = be-situated
esos = housemaster
esṛ = blood
ēsús = good
éteros = second
eti = even
étiqe = even
etmṇ = soul
ētṛ = inside
ētros = vivid
eukō = be-used
eusō = burn
ewō = get-dressed
extrōd = from
ḗpijos = relation
gálgaljō = talk
galnos = power
galnos = gaul
gangō = pin-down
gar = indeed
garsijō = talk
gāudhējō = rejoice
gaudhjom = joy
ge = at-least
geigō = be-bitter
geimō = sprout
geisā = gravel
geltis = embryo
gelu = ice
gemō = be-loaded
gemros = son-in-law
genesājō = create
gengā = gum
genjos = gender
genmṇ = germ
genos = kin
gentis = family
gentlom = birth
gentṓr = parent
gentrīks = parent
gentus = procreation
genu = knee
genus = maxilla
gercō = gather
gergō = wind
gerjō = wake-up
gerlós = old
gerō = become-old
gersā = network
gerwós = veteran
gesō = wear
geulom = ash
geustis = taste
gewō = resound
ghabhlom = fork
ghabhros = goat
ghaidīnós = goatish
ghaidos = goat
ghaisējō = stick
ghaisom = spear
ghaisom = stick
ghaitā = hair
ghálerom = disgrace
ghanos = yawn
ghansōr = goos
ghastā = spearshaft
ghawō = call
ghawōd = not
ghebhlā = head
ghedō = defecate
ghei-ke ghāi-ke ghod-ke = this
gheidhō = long-for
ghéimentos = wintry
gheimṛ = winter
gheimrīnós = winterly
gheipō = sob
gheislos = hostage
ghelbō = boast
ghelijō = growl
ghelnom = lip
ghelō = incise
ghelus = tortoise
ghelwos = vegetable
ghelwos = green
ghēmi = arrive
ghenghō = step
ghēr = hedgehog
gherdhō = encircle
gherghros = pod
gherijai = desire
gherō = lend
ghertom = butter
gherús = small
ghesṛ = hand
ghesris = glove
ghestos = hand
ghētis = arrival
ghetlā = handle
gheughō = veil
gheusō = hear
gheutis = mould
gheutlom = vase
ghéwejā = hollow
ghewos = space
ghi = certainly
ghighējō = come-back
ghirrijō = whine
ghjājō = gape
ghjems = winter
ghlaghos = crossbeam
ghlastos = blue
ghlendhō = study
ghleumi = joke
ghloidos = luxury
ghlōmi = glimmer
ghloumos = joke
ghḷtnós = golden
ghḷtom = gold
ghlustis = flourishing
ghṇdhus = cancer
ghṇdō = receive
ghneumi = caress
ghodos = rump
ghoilos = joyful
gholwā = caluum-caput
ghórdejom = barley
ghordhos = enclosure
ghorejai = encourage
ghornim = pleasantly
ghoros = intestine
ghorsejō = erect
ghortos = garden
ghosdos = starvation
ghosóm = ate
ghóstipots = guest
ghostis = foreigner
ghouros = terrible
ghowejō = pay-attention
ghradjai = step
ghrāsmṇ = grass
ghrāsom = grass
ghrebhō = bury
ghrēdhus = hunger
ghreibhō = seize
ghreim∂n = ointment
ghṛējō = be-empty
ghremō = grumble
ghrendhā = cornice
ghrendhos = lock
ghrendō = gnaw
ghrēw = early
ghrewō = grind
ghrewō = fall-into
ghromos = roaring
ghronos = mark
ghroudos = ball
ghrowā = pebble
ghudjō = do-harm
ghundō = pour
ghwerā = beast
ghwērīnós = beastly
ghwērós = wild
ghwobhros = smith
gh∂bhējō = own
gh∂rtā = tip
gibbā = hump
gígisai = happen
gignō = beget
gigrós = sharp
gjewō = chew
glabhō = plane
gladhros = even
glaghā́ = protest
glakti = milk
glegos = docile
gleibhō = adhere
gleis = mouse
glēkis = intelligent
glembhō = include
gleubhō = peel
glínāmi = stick
globhos = globe
glōghis = point
gloidos = rubber
gloijós = sticky
gloitṇ  = glue
glokijō = clack
glomos = yarn
glōs = sister-in-law
glujō = swallow
gl∂gjēs = ice
gnājō = produce
gnāmi = gnaw
gnās = offspring
gnāskai = be-born
gnātós = born
gnebhis = fleece
gnebhō = pluck
gneibhō = raze
gneichō = lean
gneidō = scrape
gnōros = evident
gnos = native
gnōsmi = recognize
gnōtis = knowledge
gnōtlom = sign
gnōtós = known
gnōtṓr = knower
gnoubhos = bud
gnōwos = wise
golbhnos = dart
gombhos = jaws
gomos = load
gonējō = produce
gopos = jaws
gorbos = wrinkle
gorgnóm = sadness
gorgós = sad
goulos = oral
gouros = crimpy-hair
grakijō = cackle
grammā = rheum
grānom = grain
gṛbeinos = hornbeam
gṛbējō = have-wrinkle
gṛbhō = scratch
grebhos = net
gredō = scratch
gregs = herd
gremjom = lap
grendjom = crown
gretlom = cradle
greubhō = go-aside
greugō = bend
greumō = scrape-off
greutō = solidify
grṇdhís = grown
grōbhos = oak-tree
grōdis = hail
groumos = crumb
grundijō = grunt
grutis = curd-cheese
gudom = bowels
gugā = ball
gupā = cellar
gurnos = back
gusnō = taste
gutṛ = throat
idhei = there
ikjō = reach
ili = groin
īljō = send-away
imde = from-there
immō = more
ipjō = oppress
is, id = this
īsarnom = iron
ita = so
itājō = journey
itaqe = and
íteros = different
itim = likewise
itṛ = way
iwe = like
ī́nekmi = convey
jagjō = worship
jāgjus = pious
jāi = yes
jālos = conspiracy
jāmi = pass
jāmi = already
jáneumi = conspire
jā́nuwā = entrance
jeghō = persecute
jegis = ice
jekō = tell
jekos = healthy
jēlom = desert
jemō = hold
jemós = twin
jentēr = cousin
jeqṛ = liver
jesō = ferment
jeunis = right-way
jeus = broth
jewesdiks = judge
jewō = help
jewom = barley
jéwornjom = cereal
jewos = law
jṇdros = exuberant
jṇtō = desire
jod qid = because
jodhei = where
joinkos = bulrush
jom = when
jomde = from-which
joqe = and
jori = wherefore
jorkos = roebuck
jōrom = season
jōrós = conspirator
jos (je), jā, jod = that
jṓsneumi = begird
jota = how
jota sei = alike
jóugsmṇtom = beast-of-burden
jówestos = just
jucis = eternal
judhejō = command
jugóm = yoke
jungō = join
júwenis = young
juwes / juwe = you
juwṇkós = young
júwṇtā = youth
juwōn = young
j∂kējō = throw
j∂kjō = eject
ka = certainly
kábṇlos = colt
kabōn = horse
kadhō = keep
kadō = fall
kādos = trouble
kadros = saint
kaghlā = opening
kaghos = enclosure
kaidō = cut
kaikos = blind
kailom = augur
kaipā = onion
kairós = untouched
káisṛjēs = long-hair
kaisrom = hair
kaitom = heath
káiwelos = exclusive
kákabā = partridge
kakkājō = defecate
kaklājō = cackle
kákneumi = promote
kakō = thinnen
kaldējō = be-experienced
kaldos = blister
kalēiks = cup
kalgōn = fog
kālis = spot
kalkis = heel
kalwos = bald
kambos = bent
kāmi = love
kamō = press
kampos = land
kánāmi = dig
kandō = glow
kánkestos = colt
kankus = branch
kanmā = leg
kanmṇ = song
kanō = sing
kantos = wheelrim
kaplos = tool
kāpos = land-estate
kaprā = goat
kapros = goat
kaput = head
kareinā = keel
karkar = fortification
kárkarjō = announce
karkros = crab
karnājō = pin-down
karōn = limb
kāros = beloved
karpō = collect
kárrēkā = rock
kartús = hard
kasnos = grey
kasterlom = castle
kastra = camp
kastrājō = prune
kastrom = scissors
katēsna = chain
katsājai = meet
katsājō = gather
kattā = cat
katus = fight
kaukos = vessel
kaulis = cabbage
kaunós = shameful
kawdō = hit
kawō = hit
káwonā = owl
ke = of here
ke kā kod (eke ekā ekod) = this
kei = here
keidō = go-down
keimēx = bug
keimoi = lie
keimos = colorant
keiros = dark
kéiwijos = civil
keiwis = citizen
kekājō = bind
kekātrīks = scar
kekō = leap
kékuros = tame
kēlā = chamber
kēlājō = hide
keldō = strike
kelgā = mystery
kéliknom = penthouse
kelmos = helmet
kelō = push
kélodhros = snake
kēlom = arrow
kelos = cover
kelots = boy
kelsō = be-high
kelujō = travel
kelus = road
kémelom = heaven
kémeros = lotus
kemjō = hum
kemō = strain
kemos = hornless
kenēs = ash
kenkai = hesitate
kenklom = tendon
kenkō = weigh
kenkos = hook
kenō = arise
kentom = rag
kentrom = prick
kepō = do-harm
keqō = dirty
kérberos = weasel
kerdhjos = herdsman
kerdhō = range
kerdhos = group
kerdos = profession
kerkō = grow-thin
kerkos = hen
kernos = excavator
kernós = frozen-snow
kerom = hair
kersnā = dinner
kersō = mutilate
kersṛ = head
kerwos = deer
ker∂srom = brain
kesdō = withraw
kēsmi = restrain
kesnus = garlic
kesō = comb
kētjā = room
keubō = curve
keudhō = hide
keukō = warp
keulom = swelling
keusō = rent
kēwējō = sway
khákhatnos = laugh
khamos = hook
khéderos = ivy
kighrós = agitated
kikēr = pea
kikjā = woodpecker
kiklēskō = invoke
kiklós = cold
kíkōnjā = stork
kīkus = muscle
kina = from-this-side
kingō = gird
kintos = previous
kippos = peg
kirknos = compasses
kirkos = circle
kiskā = biceps
kistā = basket
kíteros = of-this-side
kitōd = immediately
kitrōd = towards-this-side
kiwos = colour
kī́keumi = become-vigorous
kjājō = assort
kjējō = activate
klādis = damage
kladjos = sword
klagjō = clang
klāmājō = yell
klambós = mutilated
klāmi = embank
klamrós = weak
klāros = tablet
klārós = loud
klāstis = convocation
klaudos = lame
klawdō = close
klawos = nail
klāws = key
klawstós = closed
kḷdis = mountain-path
kḷdos = wood
kleinos = maple
kleitis = hut
kleitrom = support
kḷējō = be-hot
kḷējō = name
klepō = steal
kleumi = listen
kleumṇ = hearing
kléumṇtom = reputation
kleusō = obey
kleustis = obedience
kleutis = listening
kleutō = raffle
kleutrom = story
klewō = wash
klewos = glory
klínāmi = cause-to-slope
klisrós = gentle
kḷjō = divide
kḷneumi = hear
klṇgō = sound
kloiwos = steep
klopnis = valley
klounis = buttock
kḷpros = wine-cask
kḷtos = hot
klūtós = famous
kluwējō = be-named
kḷwijō = defame
kmāmi = get-tired
kṃertos = lobster
kṃros = curved
kṃti = with
kṃtom = hundred
knakos = yellow
kṇjós = recent
knokos = neck
knouks = nut
kṇsējō = opinate
kṇstṓr = spokesman
knuwā = walnut
kobom = success
kodējō = thurify
koilús = healthy
kóilutāts = health
koimā = agreement
koimos = lovely
koinos = foenum
koinós = akin
koisā = occupation
koitús = manner
koksā = hip
koksednīks = hip bone
kolignos = dog
koljō = stick
kolmṇ = summit
kolmos = stalk
kolnis = hill
kolnom = pile
kolnos = one-eyed
kolsos = neck
kólumbhos = dove
kom = with
kómāglom = collection
kómjougos = union
komjugs = consort
kómmoinis = common
kommoinitā́ts = community
komnom = meeting
kómnōmṇ = surname
kómopjom = equipment
kōmos = mass
kómplēnos = complete
kómsqṛtos = perfect
kómtḷtis = patience
komtrōd = against
kómwoirjom = court
kómwoistis = conscience
kōnājai = try
konkejō = burn
konkhā = shell
kōnos = top
kophos = hoof
kopnos = haven
kóqros = dirt
korbhis = basket
koris = acarian
korjom = leather
korjos = army
korkos = mud
kormnos = bleach
kormōn = ermine
kormos = pain
kornīks = crow
kornos = cherry-tree
kṓrukos = bag
korwos = raven
kósolos = hazel
kostā = rib
koubos = joint
koupā = cup
koupnā = lot
koutā = hut
kowos = hollow
kowṛ = cavern
krāmi = mix
krasi = tomorrow
krāsrōn = bumblebee
krātis = network
kratsos = plump
kṛdḗn = hinge
kṛdhōn = carbon
kṛdi / kṛdjom = heart
kṛdijai = get-angry
kṛdjō = rock
kṛdsus = shirt
kréddhēmi = believe
kreidhrom = sieve
kreimṇ = crime
kreitsō = shake
krekō = weave
kremājō = burn
krēmi = create
kremom = beer
krémusom = onion
krenghos = ring
krenktis = scar
krépāmi = crackle
krepō = precipitate
krepús = strong
krēqā = border
krēskō = grow
krētā = chalk
kretō = cut
kreugō = cry
kreuks = cross
kreumi = stock
kreupō = get-encrusted
kreutō = agitate
krēwō = touch
krigā = cry
krinō = sieve
kripsnis = mane
kripsos = curly
kripstā = crest
kristājō = shuttle
kritis = difference
kṛjēs = rot
kṛklos = slender
kṛnāmi = rot
kṛnos = rotten
kṛnu  = horn
krōbhtus = devotion
krokijō = shriek
kroknos = anorak
krotjājō = shake
krous = leg
krowos = shelter
kṛpjos = shoe
kṛpos = body
kṛsējō = be-scratched
kṛsnos = black
kṛsō = run
kṛstus = course
kṛsus = cart
krustā = icicle
krūtis = dome
kruwós = blood
kṛwos = curved
ksentis = briar
kserós = dry
ksnowātlā = razor
ksnujō = shave
ksūlom = post
kúbāmi = lie
kudājō = reprove
kukulājō = cockoo
kukūlós = cockoo
kūlā = hiding-place
kūleks = gnat
kūlos = ass
kumbhā = pot
kumbō = recline
kūmós = heap
kúnejos = wedge
kupjō = demand
kurnos = foal
kusdhos = treasure
kusis = kiss
kūtis = skin
kuwējō = be-pregnant
kuwos = whelp
kúwṛos  = powerful
kwāimi = acquire
kwatsos = cheese
kweidos = white
kwōn = dog
k∂pjō = catch
k∂psā = box
k∂ptos  = captive
k∂sējō = lack
k∂stos = pure
k∂tos = sharp
k∂wējō = beware
labhō = take
laghā = spade
lāgō = droop
laiwos = left
lājō = scold
lajos = fat
lakertos = forearm
lakus = lake
lalājo = babble
lalu = penis
lāmā = poodle
landhom = frypan
lāōs = home-god
lāpos = cow
lapsā = lamp
latēks = liquid
latom = day
lāurā = stonework
lawō = benefit
lāwós = team
lawtlom = benefit
lā́mṇtom = tell-off
ledō = release
leghō = lie
leghos = lay
leghskā = settlement
leghskós = lazy
leghtrom = support
leghús = light
légneumi = wring-out
legō = collect
legs = law
leibs = drop
leidmi = permit
leiglā = spoon
leigō = jump
leiljom = lily
leinō = avoid
leinom = flax
leipā = lime-tree
leisā = parterre
leitō = go
leitos = seaside
lembō = hang
lēmi = grant
lemō = break-up
lemsos = phantom
lendhā = spring
lenghmi = declare
lēnis  = weak
lentos = juniper
lepō = stutter
lergos = flat
lēsanks = slate
lesō = pick
leswos = middling
lētis = concession
letrom = leather
leubhos = dear
léudheros = free
leughō = lie
leukō = shine
leukós = bright
leuks = light
leuksmṇ = light
lēumi = damage
leups = leaf
lewis = sickle
ligājō = bind
likējō = be-allowed
limpō = stick
linghō = lick
līnō = oint
līnós = ointed
linqō = leave
lipējō = be-sticked
lippā = rheum
liprós = greasy
litājō = appease
litwos = rod
lṃbō = sip
lṇcō = tire
lṇghros = light
lōbā = crime
lodi = late
loghējō = lay-down
loghjom = site
loghos = deposit
loigos = calf
loigós = penury
loimos = mud
loiqnom = lend
loiqós = remaining
loisā = tablet
loisós = mild
loksos = lax
loksós = slanting
loktos = fault
londhom = land
londhwos = hip
longhros = worm
lordós = twisted
lorgā = footprint
lorgos = club
lostos = spear
loudis = praise
loughjom = oath
lougos = twig
loukejō = illuminate
loukētjos = radiant
loukos = glade
loukós = radiance
louksā = window
louksnā = moon
louksos = lynx
lousēn = louse
loutsā = whore
lowā = hair
lowō = wash
lowtrom = bath
lubhējō = like
lubhjā = herb
lubhros = bast
ludhóm = went
lugējō = be-broken
lugjā = hole
lugnós = flexible
lugtos = multitude
lukējō = shine
lukskējō = light-up
lúnāmi = split
lūnós = unbound
lutom = dirt
lūtós = unbound
luwō (lewō) = unbind
luwō apó = acquit
l∂bjom = lip
l∂kesājō = tear
l∂kjō = trap
l∂kós = tearing
l∂nchijóm = lung
l∂pējō = be-flat
l∂pods = stone
l∂skējō = fancy
l∂tējō = be-concealed
machos = youngster
machotis = youth
mághneumi = defend
maghos = field
magō = form
mājō = prosper
mākājō = pit
makēn = pouch
mākesjā = wall
makrós = slender
mammā = mum
mān = so
mānājō = spring
mánnusos = man
mānos = good
maqā = girl
maqos = boy
máreskos = marsh
margōn = boundary
mari = sea
markos = horse
masdos = mast
mātējō = designate
mātḗr = mother
māterós = solid
mātérterā = aunt
matlā = hammer
mauros = gloomy
mā́kōn = poppy
ṃbhros = storm
mē = not
me = me
medai = ponder
medgós = gull
médhidjōws = midday
medhjos = middle
medhu = mead
medjom = acorn
médneumi = administrate
médodiks = doctor
mēdos = valuation
meicō = move
meidō = scratch-out
meidos = prestige
meilēts = warrior
meinom = purpose
meitō = lack
meitrom = agreement
meiwijós = smaller
mejājō = flow
mejnō = change
mejō = exchange
mejtis = shift
mēknos = lip
meldhjā = thunderbolt
meldhō = pray
melit = honey
meljom = millet
melkō = rub
melmṇ = article
melō = grind
melos = strong
melsō = deceive
melwom = flour
membhō = punish
mēmi = measure
mēmsóm = meat
mendhai = be-interested
mendhō = stir-up
mendō = suck
mendom = fault
menghos = frequent
mengō = disguise
menis = dace
menmṇ = intellect
menos = sense
mēnsis = month
mentā = rod
mēqos = moment
mercō = make-black
mergā = fork
merghā = snare
mergis = filth
mergō = sink
merkēds = charge
merkō = flimmer
mérneumi = worry
meros = simple
mersō = block
merwos = insipid
mesgō = communicate
meslā = blackbird
mestis = measure
mestós = measured
mētā = post
meti = in-the-middle
mētijai = measure
mētis = dimension
metō = reap
metrom = measure
meudos = proud
meugō = cheat
meukō = scratch
meus / muskós = muscle
ṃgadhós = magnificent
mighlā = mist
míkāmi = flimmer
miljom = red-ochre
mimdō = meet
mímnāskō (memna) = remember
míneumi = reduce
minghō = piss
mínusi = less
misdhom = salary
misgā = whey
miskejō = mix
mlājō = weaken
mlākós = stupid
mlātóm = flour
mḷdhos = permissive
mḷdsnos = softened
mḷdus = soft
mḷduwijō = soften
mḷgājō = anounce
mlīnós = slack
mḷjos = false
mḷkāmi = weaken
mḷnos = dark
mlōdhrós = lofty
mlōskō = appear
mḷsos = slow
mḷwā = mallow-plant
mṇdōmi = commit
mṇējō = remain
mṇijai = tower
mṇjō = consider
mṇkos = defective
mṇkstrom = shaker
mṇsjai = intend
mṇtijai = put-on
mṇtis = mind
mṇtō = chew
mṇtom = chin
mṇtos = mention
mṇtrājō = wipe
mṇus = hand
mṇwos = scant
mō = but
mōdos = perseverance
modos = measure
moghjos = pleasant
moghō = can
moghtis = might
moghtrom = means
moighos = pee
moilos = mild
moinijai = fortify
moinis = obliged
moinja = walls
moisos = sheep-skin
moitājō = exchange
moitmos = thanks
moitwos = mutual
mojnos = exchange
moksi = soon
molā = millstone
moldhā = occipital
moldhos = prayer
moleinā = mill
mōlestos = annoying
molgējō = milk
mōlis = mass
moljā = coast
mōlos = effort
molpā = pride
molqos = wet
moltlom = hammer
mondō = adorn
mondós = whelp
monejō = warn
mongos = neck
monīli = collar
monos = neck
montis = hill
morā = delay
morā = nightmare
morcós = dark
mordējō = bite
morignā = woman
morjods = thigh
mórmoros = panic
morom = berry
moros = fatality
mōros = renowned
mōrós = stupid
mōs = character
mosgom = cerebellum
moukos = mucus
mouros = slop
mousos = weed
moutos = penis
mowejō = move
mreghmós = skull
mṛējō = deserve
mṛghús = short
mṛijai = die
mṛjos = pubescent
mṛkā = carrot
mṛkējō = be-withered
mṛkos = disabled
mṛktos = speckled
mṛmeikā = ant
mṛmrājō = murmur
mṛtājō = crush
mṛtāsjom = mortar
mṛtis = death
mṛtos = dead
mṛwos = dead
mūdlom = detergent
mūdnós = clean
mudstos = must
mugijō = moo
munkō = blow out
mūs = mouse
muskā = fly
muskos = moss
músnāmi = secrete
mūtrom = mud
muttijō = mutter
muttis = speechless
m∂dējō = be-wet
m∂gis = more
m∂glos = noble
m∂gnán∂mos = magnanimous
m∂gnos = big
m∂gtājō = honour
m∂rnamói = plunder
ṇ = un-
nantis = courage
nāsis = nose
natrīks = serpent
nawāgós = sailor
nāws = ship
ṇbhudhnóm = abyss
ṇcḗn = groin
ṇdha = then
ṇdherós = underly
ṇdhētós = unmade
ṇdhi = in-excess
ṇdwojos = sincere
nē = no
nebhis = cloud
nebhlā = fog
nedis = nettle
nedjos = near
nedō = link
nedsā = net
nedskō = bind
neghō = penetrate
neghrōn = kidney
nei = not-at-all
neicō = wash
neidō = humiliate
neikō = winnow
neitom = rivalry
neiwós = depressed
nékāmi = kill
nekopīnós = unexpected
neks = death
némētom = sanctuary
nemō = distribute
nemos = forest
nemots = enemy
nepēts = grandson
neptis = grand-daughter
neqe = and-not
neqid = nothing
neqis = nobody
neqom = never
neqos = someone
neros = soldier
nérteros = lower
nertos = strong
nesros = modest
ṇeu = without
neudō = spend
neukos = myop
new(ij)os = new
newājō = renew
newṇ = nine
néwṇos = ninth
newō = nod
newotāts = newness
ṇgnōtós = unknown
nī = down
nijóm = lead
niktis = corn
nínāmi = befriend
nīqos = inclined
nisdos = nest
nitējō = shine
nitjos = usual
nī́teros = inferior
ṇjousjom = unjustice
ṇjoustos = unfair
ṇkējō = need
ṇkneumi = arrive
ṇmrótijos = immortal
nṃtos = bending
nṇkskai = find-by-chance
nocējō = put-off
nócodos = naked
nōdos = knot
noibhos = holy
nōinos = none
nokejō = destroy
nom = so
nom nē = do-not
nōmṇ = name
nōmnājō = name
nomṛ = precision
noqterinós = night
noqtis = night
nosejō = free
nōunā = famine
ṇprobhwos = wicked
ṇqijētós = restless
ṇserós = our
ṇsis = sword
ṇsloimis = unmuddy
ṇsme = we
ṇswodhros = extraordinary
nū      = now
numki = now
ṇwidis = ignorant
n∂tis = nates
obhi = middle
óbrusjā = flask
ochis = worm
odáugjai = aggravate
odējō = smell
odhrom = enclosure
odjō (ōda) = hate
ōdjom = hatred
odós = odor
oghlejō = trouble
oghlos = annoyance
ogmos = track
oidējō = be-swollen
oighai = depart
oimos = march
óinoikos = single
oinos = one
oinowṛstós = simultaneously
oisjā = rudder
oisos = that-one
oitmi = fetch
oitos = oath
oiwos = yew
okējō = doubt
ókētā = harrow
ōkinós = ready
okris = summit
oktōu = eight
oktowos = eighth
ōkúpteros = hawk
ōkús = swift
olejō = heat
olējō = destroy
olgjā = tendril
ōlim = formerly
oljoi oljāi olja = all
olmos = elm
ōlnā = elbow
ólteros = further
óltṃos = furthest
oltrōd = over-there
olwā = sedge
omos = firm
ōmós = raw
omsos = shoulder
onbhlos = navel
onchis = fingernail
oncṇ = ointment
oncō = oint
oncōl = coal
ondos = rock
onējō = blame
ónerjos = dream
onghlos = nail
onjos = another
onkājō = groan
onkos = hook
onos = load
ónteros = second
ópitjos = last
opjō = choose
opnā = wealth
ópopā = hoopoe
opos = work
opos esti = be-necessary
ops = riches
oqō = see
oqos = eye
ōrā = edge
ōrājō = pray
orbhis = disk
orbhjom = inheritance
orbhos = orphan
ordhos = hammer
orgājō = beat-up
orghis = ball
orghós = incited
ormos = poor
oros = mountain
orús = high
ōs = mouth
osbhos = knot
osdos = branch
osēn = autumn
oskos = ashtree
ōsmi = open
ósonos = ashtree
ostis = bone
ōstjom = aperture
oucós = wet
oudṇ = land
ougros = cold
ousis = ear
ṓw(ij)om = egg
owājō = cheer
owis = sheep
pādhlom = sustenance
pagos = region
pags = peace
pālājō = protect
pálejā = straw
pálowos = grey
palpājō = touch
pámponos = vine-leaf
pandos = bent
panknos = swelling
pankō = swell
pannos = rag
pāpeljos = butterfly
paplā = swelling
pareikā = concubine
pārējō = come-out
parkō = refrain
parsā = sparrow
pasknis = food
pāskō = feed
pāsmi = heed
pāsós = relative
pastos = fix
pāstus = pasture
pau = a-bit
paukos = little
paulos = small
pāwṛ = fire
pedjós = worse
pedlom = sandal
pedom = footprint
pegtos = chest
peidō = grow-fat
peigō = annoy
peikā = woodpecker
peikō = adorn
peikos = magpie
peiks = pitch
peimis = quick
peitus = resin
pējō = insult
pekō = comb
pektēn = comb
pektō = comb
peku = cattle
peldō = impel
pelkō = move
pelnis = skin
pelō = make-money
pelom = surface
pelsā = rock
pelu = much
pelupoikos = variegated
pēlwis = dish
pelwos = dust
pēmṇ = damage
pendō = hang
penō = work
penom = mud
penos = provision
penqadkṃta = fifty
penqdekṃ = fifteen
penqe = five
penqstis = fist
penqtos = fifth
pēnsús = sand
pentō = track
peqō = cook
peqtis = cooking
peqtós = cooked
peqtṓr = cook
per(i), per(ti) = about
perijō = experience
perístānom = religion
perknā = trout
pérkūnjom = mountain
perṃós = absolute
perom = besides
peróm = feather
peros = farther
pérperṇks = turned-aside
perqos = oak
persā = heel
persnā = ham
persō = splash
pertā = pole
perti = otherwise
péruti = last-year
pesdō = fart
pesnis = penis
peterós = wing
pétḷos = meager
petō = fly
petsnā = feather
petsnós = bird
peumi = understand
pewō = clean
pibō = drink
pigējō = be-annoying
pikrós = sharp
pilos = hair
pīmós = fat
pinjos = stab
pinkō = paint
pinsō = crush
píperi = pepper
pipjājō = squeak
piptō = fall-down
piskis = fish
pitús = food
piwōn = fat
plabrājai = babble
plākejō = advise
plākos = flat
plākos = wide
plānos = flat
plārom = floor
plātom = surface
plātús = broad
plautos = flat-footed
pḷdājō = paddle
plēdhwis = crowd
plēis = more
plēistos = greatest
plējós = greater
plékāmi = fold
plektō = plait
plēmṇ  = filling
plēnós = full
plētis = filling
pletjā = shoulder-blades
plētós = full
pleudō = flood
pleumōn = lung
plewō = flow
plighā = appendix
pḷmā = palm
pḷnamaí = approach
pḷnāmi = fill
plṇgō = strike
plousmā = feather
ploutos = board
plówijā = rain
plówijom = ship
plowós = boat
pḷowós = grey
pḷtáwijā = earth
pḷtnos = flatness
pḷtom = coat
plúwaidhom = lead
pḷwods = swamp
pṇdēks = paunch
pneusō = breathe
pṇgō = nail
pṇtō = spread-out
podjom = relief
pods = foot
poimēks = pumice
pōimōn = shepherd
pojejō = get-drunk
polis = city
polkā = fallow
polnēks = thumb
polnō = fall
polpos = scene
poltos = porridge
pondos = weight
pōnom = drinking
pontis = way
poqós = cook
porā = air
porejō = convey
porkos = pig
pornós = feather
porsis = bull
porsōd = far
portājō = carry
pos(ti) = after
pósteri = afterwards
pósteros = subsequent
póstṃos = last
postrōd = backwards
potējō = hold
poti = towards
potijai = acquire
potis = master
pōtis = drink
pōtlom = glass
potmos = span
potnjā = mistress
pōtṓr = drinker
pougā = buttocks
poughos = virginal
pougnos = fist
pounā = swelling
poutos = penis
powejō = clean
póweros = boy
powros = pure
prāi = before
práighesto = at-hand
práiloghos = present
práinōmṇ = name
práiteri = along
prāmos = first
pratis = fern
prāwos = first
preistos = preceding
prējō = fan
prekō = beseech
preks = plea
premō = press
prepō = look-like
presō = press
pretjom = price
pretō = realise
préwijos = previous
prewō = hover
pṛgā = portico
pṛijō = give-birth
prijós = dear
prījós = foremost
prīskos = ancient
prīsmos = first
prītis = pleasure
prītós = pleased
pṛkā́ = furrow
pṛknos = motley
pṛkskā = question
pṛkskō = ask
pṛnāmi = sell
pṛnos = past
prō(d) = forwards
próbhoudhos = attention
probhwājō = prove
probhwos = good
prṓddōmi = put-forth
prod∂tṓr = traitor
prōi = morning
proitis = departure
prokós = suitor
prokos  = advanced
promos = principal
proqēd = near
proqos = nigh
prósēdjom = kindness
próstōrnos = extended
prostos = promontory
próteros = first
proti = against
prōtós = assigned
prousijō = irritate
pṛptus = form
pṛqos = coloured
pṛsnā = piece
pṛsom = leek
pṛstis = prominence
pṛtis = part
pṛtus = ford
prunsō = freeze
prúsneumi = water
pruswā́ = frost
pteljā = lime-tree
pujō = molder
pūjós = righteous
pukos = tail
pulgā = lock
pūlós = putrid
pungō = punch
pūpos = child
pūrós = core
pusbhis = groom
pusjō = inflate
puslēks = flea
pustlā = pustule
pūtējō = be-rotten
pūterós = rotten
putlom = child
pūtós = clean
puwējō = reckon
puwos = pus
p∂grós = sure
p∂gtós = fixed
p∂ra = close-to
p∂ros = before
p∂strom = page
p∂tējō = lie-open
p∂tēr = father
p∂terā́ = saucer
p∂tjai = suffer
p∂trjā = fatherland
p∂trjos = fatherly
p∂trujós = uncle
p∂wējō = fear
qād = which
qālis = how
qām = as
qāqos = whoever
qasjos = basket
qā́wṇtos = how-great
qdnos = magic
qe = and
qedos = angle
qedos = magic-force
qeisō = feel
qeistis = consideration
qejēskō = rest
qejō = compose
qejtis = collection
qeklom = wheel
qekō = gaze
qeli = far
qelō = circulate
qelos = group
qelpō = curve
qelsō = furrow
qemō = swallow
qentos  = holy
qerpō = turn
qésai = complain
qestis = part
qidpe = indeed
qijētis = rest
qijētós = peaceful
qínumoi = claim
qíqeimi = estimate
qis qid = what
qisqis qidqid = anyone
qṃdō = when
qṇtjō = suffer
qodhei = where
qoi = where
qoinā́ = retaliation
qoinom = dirt
qoitrós, koitrós = fair-weather
qolkā = cushion
qolus = distaff
qom = when
qomde = where
qondhros = angelica
qori = why
qorjom = cauldron
qoros = type
qos qā(i) qod = which
qostā = cough
qot(j)os = how-many
qota = how
qote = whither
qóteros = which
qotrēd = whither
qotrōd = wherefrom
qṛeumi = handle
qrínāmi = buy
qrītóm = bought
qṛmis = worm
qṛsnos = bush
qṛtus = time
q∂ddrom = square
q∂tjō = shake
q∂trus = four-times
q∂trusnos = four-each
q∂twṛádkṃta = forty
q∂twṛádkṃtṃos = fortieth
q∂twṛatnjom = four-years
q∂twṛdekṃ = fourteen
q∂twṛdjówijom = four-days
q∂twṛes = four
q∂twṛkṃtémtṃos = four-hundreth
q∂twṛkṃtos = four-hundred
q∂twṛpods = quadruped
q∂twṛtos = fourth
rādō = shave
rāpom = turnip
rārós = dispersed
rastós = smooth
raudos = metal
raukos = tough
rāwos = grey
ṛdhjō = grow
ṛdhwos = steep
rebhā = leap
rebhājō = jump
rebhō = shield
rebhrus = tube
recos = darkness
rēd/re = dis-
regeinā = queen
regjos = kingly
regnom = kingdom
regō = direct
regs = king
regtós = right
reidhō = ride
reidhos = easy
reigō = bind
reimā = crack
rēimṇ = list
rēis = propriety
reiwos = brook
rējō = row
rekā = tick
rékneumi = range
remō = relax
rēmoi = reckon
rentus = property
rēpō = crawl
resgō = plait
resgtis = rope
rēsmos = oar
rēti = strainer
retō = run
retrōd = back
reubō = scrape-out
reudhos = red
reudhos = redness
reudō = cry
reudos = wild
reughmṇ = dough
reugō = belch
reumi = rumor
reusmṇ = throat
reusmnājō = ruminate
rew = outdoors
réwesnā = ruin
rewis = planet
rewmṇ = hair
rewō = break-off
rewos = open-land
ṛghējō = incite
rigjō = torture
ṛijai = set-out
rikjō = ruin
rínāmi = flush-away
ṛkējō = contain
ṛkēslom = door-bar
ṛklā = chest
ṛneumi = move
ṛnumái = try
ṛnutis = movement
robhos = roof
rōdhí = on-account-of
rōdhjō = endeavour
rōdō = tear
rōdos = joyful
roinos = dam
ros = spray
rōstrom = beak
rotā = wheel
ṛots = charioteer
roudhstos = rust
roudos = crying
rounā = secret
roupis = rock
routos = intestiones
rowā = pause
ṛsjā = envy
ṛskai = go
ṛtís = farewell
ṛtkos = bear
rudhējō = be-red
rudhrós = red
rudhsós = reddish
rudlós = rude
rugijō = roar
ruktus = tunic
rumpō = break
runkō = weed
rupús = shoddy
ruspājai = rummage
rwtós = collapsed
r̥nāmi = divide
r∂bhjō = rage
r∂djom = ray
r∂gājō = wet
r∂pjō = snatch
r∂tis = reason
s(w)ei = whenever
s(w)eike = thus
sāgijō = seek
sagom = mantle
saipis = fence
saitā = hair
saitlom = lifetime
saiwos = fierce
sājō = be-furious
sákrodhokjom = sacrifice
sákrodhots = priest
sakros = holy
sal = salt
saldō = salt
salēiks = willow
saleiwā = saliva
salom = swell
salús = dirty
samdhos = sand
sāmis = quiet
samos = summer
sām∂n = quietness
sánāmi = satisfy
sáneumi = perform
sankijō = enact
sapos = juice
sasjom = crop
sātis = satisfaction
sauros = sour
sā́wel(jos)  = sun
se = himself
se/sos sā/sī tod = this
sēd = apart
sēdājō = appease
sedējō = be-sitting
sedējō ambhí = besiege
sedlā = chair
sedm∂n = settlement
sedos = residence
segēts = sowing
seghdhlā = plough-handle
seghō = hold
seghos = victory
seghurós = secure
ségneumi = trap
segnom = trap
segō = sow
seikā = club
seilō = drip
seimā = band
seimṇ = secretion
seinus  = chain
seiqō = spill
sējdhlom = sieve
sējō = sieve
sékāmi = cut
sēknis = calm
seks / sweks = six
sekstos = sixth
sekūris = axe
selgō = shoot
seljos = pleasant
selkō = drag
selō = buy
selom = residence
sēlom = sowing
selwā = property
sēmi- = half
semjō = bilge-out
semli = once
sēmṇ = seed
semos = one
senchō = sing
senējō = be-old
senēks = old
senqō = sink
sentos = path
sepēlijō = bury
sépeltrom = tomb
sepō = provide
septṃ = seven
séptṃos = seventh
seqai = follow
seqi = vis-a-vis
seqō = say
seqos = separate
serō = connect
serom = liquid
sēros = long-lasting
sérpenos = snake
serpō = crawl
sesmi = sleep
sesqos = sedge
setis = visitor
sḗtjosi = less
seugō = suck
seutō = boil
sewājō = lessen
sewe = self
séwijos = his
sewō = stir-up
silējō = be-silent
síneumi = bind
sinísteros = propice
sinō = place
sinus = bosom
sisdō = sit-down
sísermi = flow
sísghrāmi = smell
síslāwos = beneficial
sisō = sow
sisqos = dry
sītús = far-reaching
sjewm∂n = seam
sjewō = sew
sjūdhlā = sewer's-awl
sjūtós = sewn
skabhjēs = scabies
skabhnom = stool
skabhō = scratch
skaiwós = left-handed
skalpō = carve
skandō = mount
skandslā = ladder
skāpos = handle
skatējō = gush
skatō = spring
skedō = scatter
skegō = hasten
skejō = shine
skekō = burst in
skelō = shall
skelos = evil
skemō = cover
skerbhō = hollow-out
skerdā = shit
skerdō = castrate
skerjō = split
skerō = spring
skeubhō = escape
skeudō = shoot
skeumō = cover
skeuros = dark
skeutō = cover
skewō = inspect
skidjō = decide
skijō = know
skindō = split
skīrós = clear
skīwṛ = shin-bone
skḷiqā = pod
skḷjō = split
skḷneumi = deflect
skṇgjō = limp
sknidā = nit
skodhos = harm
skoidos = woodpiece
skoirsās = clown
skoitom = shield
skojā = shade
skolmā = pillar
skōlos = element
skolpos = shelf
skortom = whore
skostrom = canopy
skotos = shadow
skouros = nord
skousā = trousers
skreibhō = write
skreidō = carve
skrobhis = pit
skroupos = sherd
skroutos = skeletton
skubtis = omoplate
skutājō = maim
skūtos = covering
slabai = slip
slagós = slack
slakō = hit
slatā = rod
sleibō = slip
sleidhō = glide
sleigō = smooth
sleimā = file
sleimājō = polish
sleimāks = snail
sleiwos = violet
slējús = smooth
sleubō = slip
sleugō = devour
sligōn = mattock
sḷijai = spring
sloidhos = mass
sloiwom = plum
slougos = crowd
slṛgjō = gulp
sṃ = together
smā = certainly
smalos = animal
smā́neumi = stain
smegō = desire
smeidhō = carve
smeighsli = thousand
smeikā = crumb
smeirai = wonder
smeirātlom = miracle
smeiros = wonderful
smeitō = send
smejō = smile
smekslā = chin
smelgā = turfgrass
smelō = burn
smemorjā = memory
smerdā = shit
smerdō = stink
smeros = defect
smerwā = marrow
smeughō = smoke
smitlā = stain
sṃlis = similar
sṃloghós = wife
sṃoitis = accordance
sṃóp∂tōr = sibling
smoughos = alleyway
smoughos = smoke
smudhnō = contrive
smúghneumi = slip-in
snadhō = cut-off
snāmi = swim
sneighs = snow
sneitō = curtail
sneitos = scanty
snēmi = spin
snēmṇ  = yarn
snerō = whirl
snētjā = embroidery
sneubhō = marry
sneudhs = smog
snēw∂r = cable
sṇi = apart
sníncheti = snow
snoghā = snake
sṇstus = intelligence
sṇtējō = think
sṇterí = missing
snusós = daughter-in-law
sn∂ghjō = creep
sodejō = settle
sōdjā = soot
sodjom = seat
sodóm = went
sognos = rope
soitos = magic
sōlājai = give-joy
solkos = furrow
solpos = oil
solwos = whole
solwotāts = totality
somejō = make-equal
somós = equal
sondhos = protrusion
sontejō = send
sontis = guilty
soqjos = allied
sorbhējō = sip
sorbhos = rowan-tree
sormos = flow
sorwā = entrails
soujós = left
soukos = juice
sówijā = kiss
spakos = drop
spáneumi = extend
sparos = post
sparwos = sparrow
speikā = cereal
speiksnā = prickle
speimis = thin
spekjēs = aspect
spekjō = look
spelghā = spleen
spelgis = pole
spelō = recitate
speltā = table
spēmi = extend
spēnos = nipple
speqos = cave
sperdhō = compete
sperghō = hurry
sperjō = scatter
spes = hope
speudō = hurry
spingjā = finch
spjewō = spit
spjonos = foxglove
spjwtos = spit
spleidō = split
spleighō = retire
splighstós = side
spḷndējō = be-bright
spḷtājō = cut-off
spṇdō = flutter
spoimā = foam
spoisājō = perspire
spoisnā = breath
spoljom = dispossession
spondejō = promise
spondhā = bed
spōnos = stick
sponstós = betrothed
sportā = basket
spoudā = haste
spṛāmi = tread
spreigō = abound
spreudō = accelerate
sprewō = excite
spṛgō = burst
spṛnō = move-away
spṛos = ankle
sp∂ros = thriving
sqalos = large fish
sqeros = portent
sqijā = thorn
sredhō = billow
sremsō = fray
srenkō = snore
srewō = flow
srewtis = strom
srīgējō = be-cold
srīgos = cold
sṛijō = weed
sṛkijō = repair
srodhos = sea-heaviness
sroknā = beak
srowmos = stream
sṛpā = sickle
sṛpijō = cleanse
sṛwājō = observe
sṛwos = guardian
srwtom = pipe
stādhlom = stall
stagnom = pond
stagō = remain
staknom = pool
stālos = couch
stāmṇ = arrangement
stānējō = place
stānom = place
stārós = stable
stātlom = platform
staurejō = set
stauros = stake
staurós = staked
stāwō = stop
steighō = walk
steipēts = stick
steiwā = plough-handle
stejō = condense
stejsjā = icicle
stelghō = flow-down
stelō = put
stelōn = offshoot
stelpō = stare
stembhō = stamp-on
stemō = stumble
sterbhnjom = dry-skin
sterbhō = decline
stergō = love
sterkō = befoul
sterkos = shit
sterkos = shit
sterlā = star
sternom = entrails
sternós = rigid
sterō = rob
stérolis = sterile
steros = star
stērps = trunk
stertō = snore
stertos = pinnacle
steugō = push-away
steumi = inform
steupō = hit
steutō = support
stigājō = stick
stiprós = safe
stlāmṇ = plate
stlātos = side
stlītis = lawsuit
stlokos = place
stṃnos = trunk
stṇtējō = be-delayed
stobhos = pillar
stoghos = trestle
stoighos = street
stoipejō = densifiy
stolbos = ruler
stolgos = force
stōmṇ = palate
storejō = straighten
stornjā = centre
stoudjom = study
stoupā = oakum
strāmṇ = lay
strātos = army
strātós = spread
streibā = line
streidō = hiss
streigō = draw
streigs = night-bird
strengō = restrict
strengom = string
strēnwos = active
strepō = make-noise
streubhō = make-bitter
streudō = fight
strewō = strew
strigājō = stop
strigjā = line
stringō = draw-tight
stṛneumi = sneeze
stṛnō = spread
stṛnos = extension
strudsmā = pipe
strutjos = ancestor
struwis = heap
studējō = thrash
stupējō = be-rigid
stupos = stick
st∂tis = standing-post
st∂tus = position
sū = well
sudhjom = beer
sujō = spill
sūkós = piglet
suljā = dregs
súnoros = vigorous
sūnús = son
sup = under
supā = soup
supājō = throw
sūs = pig
susājō = buzz
susdos = dry
sūtus = birth
suwids = expert
swādejō = recommend
swādús = pleasant
swāi = so
swēdhskō = become-accustomed
swēdhus = custom
sweidō = blaze
sweidos = star
sweighlājō = whistle
sweigō = seesaw
sweisdō = whistle
swekō = smell-good
swekos = fragrant
swekrús = mother-in-law
swékuros = father-in-law
swelā = sunlight
swelājō = devour
swelāks = seal
sweljos = relative
swelō = glare
swelom = sleeper
swelplos = sulphur
swemōr = be-followed
swénāmi = sound
swendhō = swindle
swepō = sleep
swepṛ = dream
swerbhō = turn
swerghō = take-care
swerō = whisper
swērús = important
swerwos = snappy
swesōr = sister
swesreinos = sister's-son
swīnós = porcine
swoidājō = sweat
swoidos = sweat
swólejā = ground
swombhós = fungus
swonos = noise
swōpijō = fall-asleep
swoplom = broom
swopnjājō = dream
swopnjom = dream
swopnos = sleep
sworā = wade
swordis = rubbish
sworēx = shrew
sworos = stick
swṛneumi = wound
swrswrājō = whisper
sw∂lējō = be-swollen
s∂kesnā = pickaxe
s∂ksom = stone
s∂pijō = have-taste
tādējō = qualify
tādhēskō = melt
tādhis = corruption
tagjō = order
taismos = dough
tājō = steal
tājots = burglar
tálejā = stab
tālis = such
tām = at-that-point
tarsós = belly
tárudos = slow
tātā = dad
tauros = bull
tausnim = silently
tausos = silent
tā́wṇtos = so-much
tēglā = tile
tegnom = beam
tegō = cover
tegos = shrine
tegtom = ceiling
tegús = dense
teibhjā = shin-bone
teknom = creature
tekō = receive
tekslā = axe
teksnā = technique
teksō = fashion
tekstā = bowl
tekstlom = web
tekwō = run-away
telmṓn = strap
telpō = get-in
telsus = ground
tembhō = spurn
temesras = darkness
temkō = result
temlom = temple
temos = obscurity
tēmos = drunken
tempos = time
tenā = ribbon
tendō = extend
tenghō = drag-away
tengō = impregnate
teni = until
tenjō = extend
tenjom = temple
tenos = ligament
tensō = extend
tentrom = string
tepējō = be-warm
tepnos = fever
teqom = passage
tercō = threaten
téredhrom = auger
tergō = wipe
tergslom = towel
terjō = rub
termēn = end
terō = cross
terpō = enjoy
terptis = enjoyment
tersā = earth
tersai = get-dry
térunos = feeble
tetkōn = woodworker
tettā = teat
téturos = turkey
teukmṇ = progeny
teukō = dig-out
teupō = knee
teurō = stop-up
teusmṇ = lot
teusqa = desert
teutā = people
tewai = observe
tewos = force
tibhjā = stalk
timējō = be-afraid
titijō = chirp
tkeimi = establish
tlāmi = endure
tlātjos = patient
tḷijō = rest
tḷnō = raise
tloqai = speak
tmāmi = cut
tṃpus = elastic
tm̥klos = curdled-milk
tm̥ktos = clotted
tṇējō = comprehend
tṇghus = fat
tṇgō = touch
tṇtos = stretched
tṇus = thin
togā = garment
toi = certainly
tōkslos = hatchet
toksos = juniper
tokwós = fugacious
tolājō = call-for
tolkos = bran
tom = then
tom-ke = then
tomos = cut
tónāmi = resonate
tondejō = shave
tonejō = extend
tongejō = express
tonslis = fierceness
tonstṓr = hairdresser
tóntenos = noise
tontrom = thunder
topnos = warmth
toqe = also
torcós = threatening
tori = therefore
tórkmṇtom = tension
tormos = bolt
torós = loud
torpejō = rejoice
torqejō = turn
torqis = necklace
torsejō = dry
torsmṇ = thunder
tot(j)os = so-many
totrēd = towards-there
totrōd = from-there
toughā = luck
touknā = thigh
trabhis = beam
traghō = drag
traghsmā = weft
trāntis = through
trebhō = dwell
tregsnos = brave
treistis = sad
trejes trija trísores = three
tremō = tremble
trenkō = incite
trepō = pass
tresō = shiver
treudō = force-in
treughos = miserable
treukō = cut-out
tríj∂tos = sea
triplós = threefold
trípḷtis = triplication
trĩs = three-times
trisnôs = three-in-a-go
tristis = witness
tritjos = third
trītós = rubbed
tṛmēts = wedge
tṛmos = termite
tṛnā = thorn
troghos = posterity
trogjā = sow
trogos = pig
tropos = way
trosejō = make-afraid
troughi = alas
trowā = ladle
trowō = gnaw-away
tṛpējō = be-torpid
tṛrpis = ugly
tṛsdos = thrush
tṛsējō = be-thirsty
tṛstis = thirst
tṛstos = dry
tṛsus = dry
trudskā = leprosy
trudsmós = annoying
truks = slaughterer
tū = you
tūljom = multitude
tumējō = be-swollen
tumlós = mound
túmolos = turmoil
tundō = strike
turgējō = swell
tūrjós = cheese
tursis = tower
tusjai = rejoice-oneself
tusnā = wave
tustijō = cough
tustis = coughing
twakos = armour
twenkō = force
twerō = enclose
twoisós = violent
twṛbhōn = whirl
twṛkos = boar
twṛmā = troop
twṛtos = quick
t∂kējō = be-silent
ucējō = be-wet
ud = out
úderos = uter
ūdhṛ = udder
ūdhros = udder
ūdhús = immediate
udsqe = on-top
ughḗn = neck
uksōn = ox
uksōr = wife
ululājō = howl
unksrā = shadow
upelos = bad
úperesū = very-well
uperi = over
úperos = high
upo = under
upóqrijom = commission
upósēdjom = fundament
upóstānom = service
úpselos = high
upsi = above
uqnós = owen
urús = wide
ustós = burnt
uta = rather
wadhis = caution
wadhō = walk
wadhom = ford
wageinā = sheath
wāghijō = cry
wai = alas
wailos = humble
wailós = wolf
wakkā = cow
walgos = bandy-legged
walnom = wall
walóm = died
wapējō = be-foggy
waplājō = scream
warnā = owl
wāros = asunder-legged
wāstos = empty
wātis = poet
watjos = legbent
we = or
webhō = weave
wédhneumi = link
wedhō = lead
wedhṛ = weapon
wedhrom = weather
wedhskō = strike
wedmṇ  = utterance
wedō = tell
weghjā = way
weghō = carry
weghtis = leuer
weghtlom = vehicle
weghtṓr = transporter
wegō = be-strong
wegō = weave
weidhō = divide
weidos = presence
weidr̥ = beast
weiks = house
wéiktomā = victim
weimṇ = loom
weipō = wrap
weiros = wire
weis = strength
weisnā = vein
weisō = flow
weitēks = agnus-castus
weitis = vine
weitō = arch
wéiwersā = ferret
wejes / weje = we
wekmi = desire
wekō = arch
weksós = convex
weldō = tear-off
welīks = bracelet
welmi = will
welnā = wave
welnos = hair
welō = see
welpō = expect
weltis = will
wélwṃen = wrapping
welwō = turn
wélwtrom = envelope
wémāmi = vomit
wēmos = beautiful
wḗnāmoi = aspire
wendhō = attack
wenēsnom = love-potion
wenjā = family
wenō = desire
wenos  = love
wenseikā = blister
went = equipped
wentos = wind
weqtis = thing
weqtlom = expression
wēr = door
werbos = whip
wereinā = sect
wergō = head-towards
wergom = work
weri = water
werjō = name
wernā = alder
wēros = true
werpō = wrap-out
wersis = male
wersmṇ = wart
wersō = drag
werstidhlom = hall
werstis = track
wertm∂n = direction
wertos = value
wertrom = defence
wérunos = belt
weskai = eat
wēskō = squeeze
wésnāmi = prick
wesnejō = bargain
wesnom = sale
wesō = stay
wésolis = cheap
wespros = evening
wesṛ = spring
wēsros = morning
westā = food
westijō = dress
westis = cloth
westos = feast
westus = dwelling
wēsus = excellent
wétāmi = forbid
wetlos = calf
wetos = time
wetsós = one-year
wetwos = old
wī = asunder
wibrājō = vibrate
widā́ = appearance
widējō = see
wídhewā = widow
widhus = willlow
widjom = wisdom
wigējō = be-strong
wijējō = be-curved
wijēskō = wither
wikis = chance
wikjō = contend
wikkā = witch
wíklutom = known
wikwos = diverse
windō = find-out
windō peri = investigate
windos = apparent
winis = cable
winkijō = shackle
winkō = win
winsō = cause
wīrós = man
wisējō = sprout
wiskom = mistletoe
wísogā = club
witājō = turn-around
wíteros = supplementary
wītjā́ = framework
witjom = curve
witus = wheelrim
wíweqmi = speak
wḷbhontis = camel
wḷdā́ = feast
wḷdhējō = rule
wḷeiqos = liquid
wḷeisō = beat
wḷējō = be-fit
wḷepējō = whip
wḷeumi = pillage
wlewā = lion
wḷghis = basin
wḷiqējō = be-liquid
wḷnā = wool
wḷōrom = strap
wḷqos = wolf
wḷtis = tuff
wḷtus = impression
wṇdā = wave
wṇghējō = be-complexed
wochējō = vow
wodā = water
wodṛ = water
woghejō = induce
woghnos = car
woghos = transport
wogsmis = ploughshare
woida = know
woidejō = orient
woidlos = basket
woidwṓs = knowing
woighos = elm
woikā = vigour
woikos = village
woikós = steadfast
woikslā = farm
woinā = punishment
woinos = wine
woisos = poison
woitā = hunt
wolējō = choose
wolgos = people
wolmos = roll
wolnos = wound
wolos = choice
wolós = willing
wolpis = fox
wolsom = damage
wolwós = round
wondhejō = wind
wondhos = hair
wōnós = empty
wopjā = water
wopsā = wasp
woqs = voice
worgjom = cannabis
wormis = worm
wornos = colour
worós = policeman
wortejō = invert
wosejō = dress
wosis = turban
wosmós = wet
wospos = garment
wṛaghmṇ = backbone
wṛdhom = word
wṛdjā = root
wṛegis = enclosure
wṛeikā = veil
wṛéikonjom = webbing
wṛeinā = harn
wṛējai = respect
wṛēn = lamb
wṛeumi = close
wṛeumi apo = open
wṛgā = vigor
wṛgējō = be-on-attack
wṛgjō = work
wṛgos = attack
wṛijō = close
wṛisdējō = laugh
wṛnāmi = persecute
wṛṇgai = grumble
wṛonkā = hand
wṛonkis = dip
wṛrādīks = root
wṛstā = rain
wṛstis = turn
wṛstos = row
wṛtō = turn
wṛtom = enclosure
wṛughis = rye
w∂drā = otter
w∂dris = leather-bag
w∂gājai = roam
w∂nskā = desire
w∂nskō = desire
w∂rbhis = perimeter
w∂rjō = set fire
w∂ros = pimple
∂gjō = affirm
∂gsājō = proclaim
∂gtis = speech
∂pjō = reach
∂snātis = harvest
