# English to Klingon
# eng to tlh
# 57 word pairs
# deliminator:  = 
#
# DAMS - The Dictionary Additions Management System
# https://github.com/attogram/DAMS
#
# This work is licensed under the Creative Commons Attribution-Share Alike 3.0 Unported License. 
# To view a copy of this license, visit http://creativecommons.org/licenses/by-sa/3.0/ 
# or send a letter to Creative Commons, 171 Second Street, Suite 300, San Francisco, California, 94105, USA.
#
a hundred tasks = Qu'vatlh
asshole = petaQ
bastard = petaQ
bile = HoH
coward = bIHnuch
curse = QI'yaH
damn = ghuy'
damn it = ghay'cha'
eight = chorgh
five = vagh
five hundred and fivety five = vaghvatlh vaghmaH vagh
four = loS
four thousand and four = loSSanID loS
fourty two = loSmaH cha'
gall = HoH
he = ghaH
hundred = wa'vatlh
hundred thousands = bIp
hundreds = vatlh
i = jIH
i see = jIlegh jIH
insignificanct = Qovpatlh
insult = baktag
it = 'oH
klingon language = tlhIngon Hol
language = Hol
me = jIH
millions = 'uy'
nine = Hut
nine thousand = HutSaD
one = wa'
seven = Soch
she = ghaH
shit = HoH
six = jav
slime = HoH
ten = wa'maH
ten thousands = netlh
tens = maH
that = 'e'
that = net
them = bIH
them = chaH
they = bIH
they = chaH
thirty = wejmaH
thousands = SaD
three = wej
two = cha'
us = maH
we = maH
what do you want = nuqneH
you = SoH
you = tlhIH
you all = tlhIH
you see me = jIH cholegh soH
zero = pagh
